,pepacton,cannonsville,neversink,Total,PercentageTotal
12/1/1999,100636,60488,15968,177092,65.39586411
12/2/1999,101024,61142,15998,178164,65.79172821
12/3/1999,101055,61651,16037,178743,66.00553914
12/4/1999,101242,62237,16037,179516,66.29098966
12/5/1999,101351,62925,16149,180425,66.62666174
12/6/1999,101445,63447,16274,181166,66.90029542
12/7/1999,101507,63956,16312,181775,67.12518464
12/8/1999,101648,64504,16348,182500,67.3929099
12/9/1999,101445,64963,16322,182730,67.47784343
12/10/1999,101320,65408,16241,182969,67.56610044
12/11/1999,101226,65968,16106,183300,67.68833087
12/12/1999,101195,66286,16070,183551,67.7810192
12/13/1999,101133,66681,15857,183671,67.82533235
12/14/1999,101133,67012,15827,183972,67.93648449
12/15/1999,101101,67662,15762,184525,68.14069424
12/16/1999,100993,68073,15729,184795,68.24039882
12/17/1999,101009,68550,15755,185314,68.43205318
12/18/1999,101148,68735,15684,185567,68.52548006
12/19/1999,100993,68907,15690,185590,68.53397341
12/20/1999,100823,69093,15690,185606,68.53988183
12/21/1999,101055,69106,15765,185926,68.65805022
12/22/1999,101211,69463,15890,186564,68.89364845
12/23/1999,101024,69649,15899,186572,68.89660266
12/24/1999,101039,69755,16004,186798,68.98005908
12/25/1999,100915,69768,16017,186700,68.94387001
12/26/1999,100683,69715,15965,186363,68.81942393
12/27/1999,100668,69728,15968,186364,68.81979321
12/28/1999,100513,70139,15988,186640,68.92171344
12/29/1999,100326,69861,15942,186129,68.73301329
12/30/1999,100420,69821,15958,186199,68.75886263
12/31/1999,100125,69808,15952,185885,68.6429099
1/1/2000,99970,69781,15958,185709,68.57791728
1/2/2000,99800,69689,15932,185421,68.47156573
1/3/2000,99551,69768,15896,185215,68.39549483
1/4/2000,99583,69596,15985,185164,68.37666174
1/5/2000,99366,69742,16146,185254,68.4098966
1/6/2000,99444,70046,16208,185698,68.57385524
1/7/2000,99382,70218,16261,185861,68.63404727
1/8/2000,99259,70351,16338,185948,68.6661743
1/9/2000,98983,70457,16404,185844,68.62776957
1/10/2000,98998,70470,16491,185959,68.67023634
1/11/2000,99106,71212,16564,186882,69.01107829
1/12/2000,98983,71953,16568,187504,69.24076809
1/13/2000,99106,72562,16574,188242,69.51329394
1/14/2000,98829,73013,16524,188366,69.55908419
1/15/2000,98614,73331,16460,188405,69.57348597
1/16/2000,98429,73676,16454,188559,69.63035451
1/17/2000,98537,74008,16527,189072,69.81979321
1/18/2000,98429,74229,16557,189215,69.8725997
1/19/2000,98198,74658,16544,189400,69.94091581
1/20/2000,98168,74920,16430,189518,69.9844904
1/21/2000,97953,75307,16491,189751,70.07053176
1/22/2000,97648,75694,16278,189620,70.02215657
1/23/2000,97465,75929,16165,189559,69.99963072
1/24/2000,97267,76205,15988,189460,69.96307238
1/25/2000,97069,76523,15912,189504,69.97932053
1/26/2000,96871,76840,15814,189525,69.98707533
1/27/2000,96673,77131,15690,189494,69.97562777
1/28/2000,96234,77117,15593,188944,69.77252585
1/29/2000,95963,77034,15418,188415,69.57717873
1/30/2000,95765,76896,15280,187941,69.4021418
1/31/2000,95493,76896,15123,187512,69.2437223
2/1/2000,95267,76827,15210,187304,69.16691285
2/2/2000,94995,76633,15257,186885,69.01218612
2/3/2000,94665,76661,15286,186612,68.91137371
2/4/2000,94456,76509,15342,186307,68.79874446
2/5/2000,94411,76523,15374,186308,68.79911374
2/6/2000,94546,76661,15422,186629,68.9176514
2/7/2000,94605,76868,15463,186936,69.0310192
2/8/2000,94710,77061,15473,187244,69.14475628
2/9/2000,94516,76730,15496,186742,68.95937962
2/10/2000,94156,76537,15532,186225,68.76846381
2/11/2000,94141,76440,15574,186155,68.74261448
2/12/2000,93722,76150,15609,185481,68.4937223
2/13/2000,93437,75804,15632,184873,68.26920236
2/14/2000,93125,75555,15697,184377,68.08604136
2/15/2000,93318,75763,15854,184935,68.29209749
2/16/2000,93348,76329,15942,185619,68.54468242
2/17/2000,93273,76578,16033,185884,68.64254062
2/18/2000,93393,77006,16059,186458,68.85450517
2/19/2000,93258,77282,16152,186692,68.94091581
2/20/2000,93303,77462,16205,186970,69.04357459
2/21/2000,93140,77683,16261,187084,69.08567208
2/22/2000,93170,77807,16315,187292,69.16248154
2/23/2000,93021,78056,16355,187432,69.21418021
2/24/2000,92932,78249,16411,187592,69.2732644
2/25/2000,92813,78830,16497,188140,69.47562777
2/26/2000,93946,79977,16782,190705,70.42282127
2/27/2000,95222,81929,17016,194167,71.70125554
2/28/2000,99583,87435,17597,204615,75.55945347
2/29/2000,103500,93942,18367,215809,79.69313146
3/1/2000,105542,96881,18729,221152,81.6661743
3/2/2000,106804,98249,19032,224085,82.74926145
3/3/2000,107863,98523,19296,225682,83.33899557
3/4/2000,108653,98651,19503,226807,83.75443131
3/5/2000,109105,98539,19683,227327,83.94645495
3/6/2000,109380,98426,19847,227653,84.066839
3/7/2000,110128,98184,20005,228317,84.3120384
3/8/2000,110859,98104,20179,229142,84.61669129
3/9/2000,111252,97943,20436,229631,84.79726736
3/10/2000,112037,98394,20980,231411,85.45457903
3/11/2000,113024,98716,21424,233164,86.10192024
3/12/2000,115011,99553,22380,236944,87.49778434
3/13/2000,117266,100260,23322,240848,88.9394387
3/14/2000,118293,99713,23797,241803,89.29209749
3/15/2000,119580,99199,24149,242928,89.70753323
3/16/2000,120225,98716,24441,243382,89.87518464
3/17/2000,121180,98619,24863,244662,90.3478582
3/18/2000,122138,98957,25341,246436,91.00295421
3/19/2000,122842,98828,25646,247316,91.32791728
3/20/2000,123687,98667,25908,248262,91.67725258
3/21/2000,123911,98474,26114,248499,91.76477105
3/22/2000,124499,98329,26346,249174,92.0140325
3/23/2000,124707,98072,26482,249261,92.04615953
3/24/2000,124950,97734,26596,249280,92.05317578
3/25/2000,125105,97540,26769,249414,92.10265879
3/26/2000,125314,97396,26949,249659,92.19313146
3/27/2000,125436,97315,27081,249832,92.25701625
3/28/2000,125748,97476,27283,250507,92.5062777
3/29/2000,126971,98571,27835,253377,93.56610044
3/30/2000,127846,98764,28105,254715,94.06019202
3/31/2000,128972,98700,28351,256023,94.54320532
4/1/2000,129253,98426,28561,256240,94.62333826
4/2/2000,130103,98152,28685,256940,94.88183161
4/3/2000,130369,98056,28844,257269,95.00332349
4/4/2000,131291,98700,29079,259070,95.66838996
4/5/2000,133060,100373,29566,262999,97.11927622
4/6/2000,134390,100309,29832,264531,97.68500739
4/7/2000,135312,99890,29946,265148,97.91285081
4/8/2000,135729,99359,29937,265025,97.86742984
4/9/2000,136672,99311,30046,266029,98.23818316
4/10/2000,137419,99424,30082,266925,98.56905465
4/11/2000,137948,99182,30091,267221,98.67836041
4/12/2000,138572,98828,30068,267468,98.76957164
4/13/2000,138995,98796,30095,267886,98.9239291
4/14/2000,139638,98555,30191,268384,99.10782866
4/15/2000,140061,98523,30227,268811,99.2655096
4/16/2000,140449,98378,30296,269123,99.38072378
4/17/2000,140468,98313,30346,269127,99.38220089
4/18/2000,140746,98329,30515,269590,99.55317578
4/19/2000,141005,98909,30670,270584,99.92023634
4/20/2000,140894,98941,30795,270630,99.93722304
4/21/2000,141005,98796,30859,270660,99.94830133
4/22/2000,141079,98877,31364,271320,100.1920236
4/23/2000,141246,98925,31920,272091,100.4767356
4/24/2000,141320,99166,32307,272793,100.7359675
4/25/2000,141338,99070,32543,272951,100.7943131
4/26/2000,141172,98764,32691,272627,100.6746677
4/27/2000,141135,98426,32781,272342,100.5694239
4/28/2000,140968,98410,32762,272140,100.4948301
4/29/2000,140838,98104,32671,271613,100.3002216
4/30/2000,140727,97943,32829,271499,100.2581241
5/1/2000,140708,97701,32995,271404,100.2230428
5/2/2000,140579,97540,32995,271114,100.1159527
5/3/2000,140523,97347,33038,270908,100.0398818
5/4/2000,140338,97218,33144,270700,99.96307238
5/5/2000,140394,96881,33062,270337,99.82902511
5/6/2000,140375,96687,33067,270129,99.75221566
5/7/2000,140375,96446,33086,269907,99.67023634
5/8/2000,140412,96462,33081,269955,99.6879616
5/9/2000,140079,96157,33173,269409,99.48633678
5/10/2000,140043,96221,33081,269345,99.4627031
5/11/2000,140505,96671,33225,270401,99.85265879
5/12/2000,140560,96897,33254,270711,99.96713442
5/13/2000,140579,97299,33307,271185,100.1421713
5/14/2000,141098,97862,33374,272334,100.5664697
5/15/2000,141135,98249,33384,272768,100.7267356
5/16/2000,141153,98265,33475,272893,100.7728951
5/17/2000,141098,98184,33596,272878,100.767356
5/18/2000,140801,97750,33572,272123,100.4885524
5/19/2000,141079,97798,33611,272488,100.6233383
5/20/2000,141005,98023,33944,272972,100.8020679
5/21/2000,140968,97975,34179,273122,100.8574594
5/22/2000,140931,97943,34379,273253,100.9058346
5/23/2000,140950,98168,34433,273551,101.0158789
5/24/2000,140987,99295,34473,274755,101.4604874
5/25/2000,141709,100083,35011,276803,102.2167651
5/26/2000,141746,100212,35016,276974,102.2799114
5/27/2000,141746,99826,34996,276568,102.1299852
5/28/2000,141394,99327,34956,275677,101.8009601
5/29/2000,141394,98925,34868,275187,101.6200148
5/30/2000,141061,98410,34739,274210,101.2592319
5/31/2000,140931,98007,34759,273697,101.0697932
6/1/2000,140801,97589,34665,273055,100.8327179
6/2/2000,140375,97267,34528,272170,100.5059084
6/3/2000,140412,96929,34528,271869,100.3947563
6/4/2000,140135,96704,34438,271277,100.1761448
6/5/2000,140190,96334,34389,270913,100.0417282
6/6/2000,140079,96285,34374,270738,99.97710487
6/7/2000,141506,96575,35404,273485,100.9915066
6/8/2000,141783,97154,35269,274206,101.2577548
6/9/2000,141617,97218,35175,274010,101.1853767
6/10/2000,141338,97041,35011,273390,100.9564254
6/11/2000,141320,96977,34808,273105,100.8511817
6/12/2000,141412,97251,34739,273402,100.9608567
6/13/2000,141486,97734,34715,273935,101.1576809
6/14/2000,141486,97975,34650,274111,101.2226736
6/15/2000,141375,98023,34616,274014,101.1868538
6/16/2000,141227,98104,34528,273859,101.129616
6/17/2000,141246,97911,34404,273561,101.0195716
6/18/2000,141264,97750,34214,273228,100.8966027
6/19/2000,141209,97895,34077,273181,100.8792467
6/20/2000,141116,97685,34101,272902,100.7762186
6/21/2000,140838,97347,34047,272232,100.5288035
6/22/2000,140876,97315,34248,272439,100.6052437
6/23/2000,140913,97476,34272,272661,100.687223
6/24/2000,140801,97315,34370,272486,100.6225997
6/25/2000,140523,96993,34473,271989,100.4390694
6/26/2000,140505,96929,34626,272060,100.465288
6/27/2000,140412,96864,34793,272069,100.4686115
6/28/2000,140727,96784,34853,272364,100.577548
6/29/2000,140301,96800,34769,271870,100.3951256
6/30/2000,140264,96559,34725,271548,100.2762186
7/1/2000,140043,96189,34660,270892,100.0339734
7/2/2000,139987,95963,34650,270600,99.92614476
7/3/2000,139546,95754,34606,269906,99.66986706
7/4/2000,139455,95722,34655,269832,99.64254062
7/5/2000,139216,95738,34700,269654,99.57680945
7/6/2000,138885,95523,34582,268990,99.33161004
7/7/2000,138700,95341,34616,268657,99.20864106
7/8/2000,138259,95143,34458,267860,98.91432792
7/9/2000,137730,94930,34487,267147,98.65103397
7/10/2000,137346,94626,34497,266469,98.4006647
7/11/2000,137528,94398,34389,266315,98.34379616
7/12/2000,137310,93942,34374,265626,98.08936484
7/13/2000,137054,93790,34325,265169,97.92060561
7/14/2000,136818,93516,34296,264630,97.72156573
7/15/2000,136581,93303,34399,264283,97.59342688
7/16/2000,137310,93516,35429,266255,98.32163959
7/17/2000,137857,93713,35389,266959,98.58161004
7/18/2000,138149,93774,35224,267147,98.65103397
7/19/2000,138205,93866,35165,267236,98.68389956
7/20/2000,138351,93957,35060,267368,98.73264402
7/21/2000,138296,93881,34946,267123,98.64217134
7/22/2000,138461,93820,34887,267168,98.65878877
7/23/2000,138461,93561,34759,266781,98.51587888
7/24/2000,138406,93379,34528,266313,98.34305761
7/25/2000,138425,93288,34438,266151,98.28323486
7/26/2000,138535,93257,34384,266176,98.29246677
7/27/2000,138572,93212,34267,266051,98.24630724
7/28/2000,138590,93303,34286,266179,98.29357459
7/29/2000,138848,93318,34399,266565,98.43611521
7/30/2000,138700,93364,34567,266631,98.46048744
7/31/2000,138756,93272,34684,266712,98.49039882
8/1/2000,138498,93333,34764,266595,98.4471935
8/2/2000,138351,93348,34744,266443,98.39106352
8/3/2000,138040,93348,34626,266014,98.23264402
8/4/2000,138094,93348,34538,265980,98.22008863
8/5/2000,138003,93288,34448,265739,98.13109306
8/6/2000,137912,93227,34316,265455,98.02621861
8/7/2000,138205,93151,34228,265584,98.07385524
8/8/2000,138076,93120,34106,265302,97.96971935
8/9/2000,137748,93120,34023,264891,97.81794682
8/10/2000,137875,93014,33876,264765,97.77141802
8/11/2000,137657,92603,33736,263996,97.48744461
8/12/2000,137583,92086,33577,263246,97.21048744
8/13/2000,137784,92162,33470,263416,97.2732644
8/14/2000,137784,92177,33341,263302,97.23116691
8/15/2000,138223,92223,33336,263782,97.4084195
8/16/2000,138296,92116,33149,263561,97.32680945
8/17/2000,138186,92025,33024,263235,97.20642541
8/18/2000,138186,91903,32857,262946,97.09970458
8/19/2000,138094,91614,32600,262308,96.86410635
8/20/2000,138351,91416,32425,262192,96.82127031
8/21/2000,138480,91157,32250,261887,96.70864106
8/22/2000,138351,90777,32075,261203,96.45605613
8/23/2000,138351,90458,32099,260908,96.34711965
8/24/2000,138113,90290,31775,260178,96.07754801
8/25/2000,137912,89956,31686,259554,95.84711965
8/26/2000,137839,89621,31504,258964,95.62924668
8/27/2000,137565,89317,31271,258153,95.32976366
8/28/2000,137236,89165,31122,257523,95.09711965
8/29/2000,137072,88906,31039,257017,94.91026588
8/30/2000,136872,88693,31058,256623,94.76477105
8/31/2000,136581,88389,30966,255936,94.51107829
9/1/2000,136290,88042,30845,255177,94.23079764
9/2/2000,136036,87681,30634,254351,93.92577548
9/3/2000,135674,87334,30680,253688,93.68094535
9/4/2000,135294,86987,30762,253043,93.44276219
9/5/2000,134750,86626,30831,252207,93.13404727
9/6/2000,134210,86308,30854,251372,92.82570162
9/7/2000,134030,86193,30914,251137,92.73892171
9/8/2000,133545,85904,30919,250368,92.4549483
9/9/2000,133114,85297,30873,249284,92.05465288
9/10/2000,132541,84877,30873,248291,91.6879616
9/11/2000,132326,84516,30850,247692,91.46676514
9/12/2000,131898,84169,30841,246908,91.17725258
9/13/2000,132004,84198,31155,247357,91.34305761
9/14/2000,131862,84154,31508,247524,91.40472674
9/15/2000,131773,84299,31710,247782,91.5
9/16/2000,131791,84198,31747,247736,91.48301329
9/17/2000,131452,84010,31775,247237,91.29874446
9/18/2000,131149,83807,31789,246745,91.11706056
9/19/2000,131238,83721,31878,246837,91.15103397
9/20/2000,130723,83620,31958,246301,90.95310192
9/21/2000,130475,83273,31789,245537,90.67097489
9/22/2000,130156,83128,31625,244909,90.43906942
9/23/2000,129837,82868,31615,244320,90.22156573
9/24/2000,129536,82579,31583,243698,89.99187592
9/25/2000,128849,82160,31546,242555,89.56979321
9/26/2000,128585,81669,31513,241767,89.27880355
9/27/2000,128322,81423,31466,241211,89.07348597
9/28/2000,127811,81192,31461,240464,88.79763663
9/29/2000,127565,80932,31391,239888,88.58493353
9/30/2000,126971,80682,31332,238985,88.2514771
10/1/2000,126568,80405,31248,238221,87.96935007
10/2/2000,126272,80184,31169,237625,87.74926145
10/3/2000,125783,79935,31132,236850,87.46307238
10/4/2000,125505,79769,31058,236332,87.2717873
10/5/2000,125019,79714,30905,235638,87.0155096
10/6/2000,124863,80004,30873,235740,87.05317578
10/7/2000,124828,80267,30804,235899,87.11189069
10/8/2000,124585,80350,30744,235679,87.03064993
10/9/2000,124239,80378,30616,235233,86.86595273
10/10/2000,123790,80447,30478,234715,86.67466765
10/11/2000,123566,80516,30447,234529,86.60598227
10/12/2000,123170,80447,30310,233927,86.38367799
10/13/2000,122946,80460,30191,233597,86.26181684
10/14/2000,122722,80488,30128,233338,86.1661743
10/15/2000,122258,80391,29941,232590,85.88995569
10/16/2000,121985,80295,29819,232099,85.70864106
10/17/2000,121540,80101,29747,231388,85.44608567
10/18/2000,121591,80295,29620,231506,85.48966027
10/19/2000,121591,80751,29656,231998,85.67134417
10/20/2000,121402,81105,29575,232082,85.70236337
10/21/2000,121231,81438,29509,232178,85.73781388
10/22/2000,120924,81755,29459,232138,85.72304284
10/23/2000,120838,81958,29347,232143,85.72488922
10/24/2000,120599,82160,29275,232034,85.68463811
10/25/2000,120225,82333,29146,231704,85.56277696
10/26/2000,119987,82521,29057,231565,85.51144756
10/27/2000,119885,82651,28937,231473,85.47747415
10/28/2000,119801,82868,28773,231442,85.46602659
10/29/2000,119070,82969,28614,230653,85.17466765
10/30/2000,118799,82998,28399,230196,85.00590842
10/31/2000,118664,83099,28220,229983,84.92725258
11/1/2000,118411,83056,28105,229572,84.77548006
11/2/2000,117804,83056,27839,228699,84.45310192
11/3/2000,117619,82984,27520,228123,84.24039882
11/4/2000,117383,82883,27300,227566,84.03471196
11/5/2000,116964,82854,27018,226836,83.76514032
11/6/2000,116646,82738,26727,226111,83.49741507
11/7/2000,116076,82593,26427,225096,83.1225997
11/8/2000,115959,82565,26190,224714,82.98153619
11/9/2000,115525,82550,25946,224021,82.72562777
11/10/2000,115243,82767,25729,223739,82.62149188
11/11/2000,114961,83085,25612,223658,82.5915805
11/12/2000,114694,83287,25424,223405,82.49815362
11/13/2000,114213,83461,25193,222867,82.29948301
11/14/2000,114113,83620,24932,222665,82.22488922
11/15/2000,113881,83880,24809,222570,82.18980798
11/16/2000,113683,84097,24625,222405,82.1288774
11/17/2000,113486,84313,24405,222204,82.05465288
11/18/2000,113189,84473,24197,221859,81.92725258
11/19/2000,112843,84704,23914,221461,81.78028065
11/20/2000,112745,84863,23733,221341,81.7359675
11/21/2000,112398,85138,23481,221017,81.61632201
11/22/2000,112135,85268,23298,220701,81.49963072
11/23/2000,111971,85412,23052,220435,81.40140325
11/24/2000,111644,85557,23000,220201,81.31499261
11/25/2000,111284,85701,23044,220029,81.2514771
11/26/2000,110778,85904,23100,219782,81.16026588
11/27/2000,110974,86250,23238,220462,81.41137371
11/28/2000,110680,86438,23338,220456,81.40915805
11/29/2000,110387,86655,23405,220447,81.40583456
11/30/2000,110192,86915,23597,220704,81.50073855
12/1/2000,109916,87204,23685,220805,81.53803545
12/2/2000,109738,87334,23753,220825,81.54542097
12/3/2000,109202,87479,23797,220478,81.41728213
12/4/2000,109056,87666,23817,220539,81.43980798
12/5/2000,108765,87782,23882,220429,81.39918759
12/6/2000,108282,87956,23951,220189,81.3105613
12/7/2000,108217,88146,23991,220354,81.37149188
12/8/2000,107847,88252,23999,220098,81.27695716
12/9/2000,107589,88283,24055,219927,81.21381093
12/10/2000,107204,88526,24140,219870,81.19276219
12/11/2000,106932,88739,24165,219836,81.18020679
12/12/2000,106692,88921,24259,219872,81.19350074
12/13/2000,106564,89180,24331,220075,81.26846381
12/14/2000,106148,89332,24323,219803,81.16802068
12/15/2000,105796,89484,24311,219591,81.08973412
12/16/2000,105478,89712,24385,219575,81.0838257
12/17/2000,105701,90229,24409,220339,81.36595273
12/18/2000,112613,95189,27770,235572,86.99113737
12/19/2000,115194,97830,28228,241252,89.08862629
12/20/2000,116311,98539,28425,243275,89.83567208
12/21/2000,116964,98587,28535,244086,90.1351551
12/22/2000,117266,98362,28694,244322,90.22230428
12/23/2000,117635,98056,28835,244526,90.29763663
12/24/2000,117602,97750,28994,244346,90.23116691
12/25/2000,117702,97557,29026,244285,90.20864106
12/26/2000,117551,97331,29066,243948,90.08419498
12/27/2000,117585,97267,29222,244074,90.13072378
12/28/2000,117451,97138,29360,243949,90.08456425
12/29/2000,117585,97058,29423,244066,90.12776957
12/30/2000,117451,97396,29558,244405,90.25295421
12/31/2000,117400,97476,29656,244532,90.29985229
1/1/2001,117249,97396,29733,244378,90.24298375
1/2/2001,116981,97363,29814,244158,90.16174298
1/3/2001,116796,97041,29860,243697,89.99150665
1/4/2001,116578,96527,29928,243033,89.74630724
1/5/2001,116545,96350,30013,242908,89.70014771
1/6/2001,116261,96205,30132,242598,89.58567208
1/7/2001,115993,96092,30177,242262,89.46159527
1/8/2001,115608,95996,30259,241863,89.31425406
1/9/2001,115459,95851,30301,241611,89.22119645
1/10/2001,115227,95706,30346,241279,89.09859675
1/11/2001,114895,95554,30328,240777,88.91322009
1/12/2001,114578,95417,30456,240451,88.79283604
1/13/2001,114097,95174,30529,239800,88.55243722
1/14/2001,113964,94885,30542,239391,88.40140325
1/15/2001,113700,94626,30612,238938,88.23412112
1/16/2001,113305,94322,30661,238288,87.99409158
1/17/2001,113024,94002,30661,237687,87.77215657
1/18/2001,112745,93683,30721,237149,87.57348597
1/19/2001,112431,93607,30730,236768,87.43279173
1/20/2001,112070,93394,30795,236259,87.24483013
1/21/2001,111644,93075,30854,235573,86.99150665
1/22/2001,111447,92649,30877,234973,86.76994092
1/23/2001,111089,92329,30873,234291,86.51809453
1/24/2001,110533,91842,30910,233285,86.14660266
1/25/2001,110322,91568,30961,232851,85.98633678
1/26/2001,110160,90777,30980,231917,85.64143279
1/27/2001,109819,90488,30980,231287,85.40878877
1/28/2001,109267,90093,30947,230307,85.04689808
1/29/2001,109024,89697,31012,229733,84.83493353
1/30/2001,108540,89317,30952,228809,84.4937223
1/31/2001,108653,89134,31007,228794,84.48818316
2/1/2001,108508,89073,31026,228607,84.41912851
2/2/2001,108427,88784,30952,228163,84.25516987
2/3/2001,108088,88435,30891,227414,83.97858198
2/4/2001,107959,88237,30845,227041,83.84084195
2/5/2001,107653,88013,30758,226424,83.61299852
2/6/2001,107637,87883,30749,226269,83.55576071
2/7/2001,107541,87797,30698,226036,83.46971935
2/8/2001,107268,87493,30661,225422,83.24298375
2/9/2001,107060,87479,30621,225160,83.14623338
2/10/2001,106868,87753,30693,225314,83.20310192
2/11/2001,107460,89058,30762,227280,83.92909897
2/12/2001,107573,89530,30758,227861,84.14364845
2/13/2001,107605,89925,30822,228352,84.32496307
2/14/2001,107798,90488,30887,229173,84.62813885
2/15/2001,108217,91066,30970,230253,85.02695716
2/16/2001,108298,92314,31030,231642,85.53988183
2/17/2001,108443,92770,31104,232317,85.78914328
2/18/2001,108524,92983,31150,232657,85.91469719
2/19/2001,108411,93303,31132,232846,85.9844904
2/20/2001,108363,93485,31229,233077,86.06979321
2/21/2001,108347,93805,31313,233465,86.21307238
2/22/2001,108298,93896,31304,233498,86.22525849
2/23/2001,108185,94018,31354,233557,86.24704579
2/24/2001,107863,94170,31420,233453,86.20864106
2/25/2001,107814,94307,31494,233615,86.26846381
2/26/2001,107573,94444,31620,233637,86.27658789
2/27/2001,107831,94793,31644,234268,86.50960118
2/28/2001,107718,94946,31724,234388,86.55391433
3/1/2001,107573,94976,31775,234324,86.53028065
3/2/2001,107220,95098,31855,234173,86.47451994
3/3/2001,107108,95082,31892,234082,86.44091581
3/4/2001,106932,95143,31958,234033,86.42282127
3/5/2001,106948,95204,32061,234213,86.48929099
3/6/2001,106948,95341,32103,234392,86.55539143
3/7/2001,106564,95295,32160,234019,86.4176514
3/8/2001,106484,95371,32085,233940,86.38847858
3/9/2001,106388,95311,31860,233559,86.24778434
3/10/2001,106212,95326,31873,233411,86.19313146
3/11/2001,106116,95158,31868,233142,86.09379616
3/12/2001,105748,95128,31878,232754,85.95051699
3/13/2001,105717,95128,31878,232723,85.93906942
3/14/2001,105653,95174,31976,232803,85.96861152
3/15/2001,105558,95326,31995,232879,85.99667651
3/16/2001,105415,95493,31939,232847,85.98485968
3/17/2001,105383,95600,31962,232945,86.02104874
3/18/2001,105462,95584,32042,233088,86.07385524
3/19/2001,105510,95676,32090,233276,86.14327917
3/20/2001,105462,95569,32146,233177,86.10672083
3/21/2001,105605,95615,32208,233428,86.19940916
3/22/2001,105860,95947,32339,234146,86.46454948
3/23/2001,106244,96414,32562,235220,86.86115214
3/24/2001,106580,96575,32643,235798,87.0745938
3/25/2001,106932,96720,32771,236423,87.30539143
3/26/2001,107092,96671,32834,236597,87.36964549
3/27/2001,107236,96736,32972,236944,87.49778434
3/28/2001,107412,96848,33038,237298,87.62850812
3/29/2001,107702,96913,33134,237749,87.7950517
3/30/2001,108266,97041,33245,238552,88.0915805
3/31/2001,109105,98104,33625,240834,88.93426883
4/1/2001,109948,98297,33804,242049,89.38293944
4/2/2001,110811,98217,33974,243002,89.73485968
4/3/2001,111415,97846,34013,243274,89.83530281
4/4/2001,111939,97557,34057,243553,89.93833087
4/5/2001,112398,97347,34121,243866,90.05391433
4/6/2001,113453,97524,34224,245201,90.54689808
4/7/2001,114545,97959,34453,246957,91.19534712
4/8/2001,116144,98844,34774,249762,92.23116691
4/9/2001,118512,99939,35070,253521,93.61927622
4/10/2001,122773,101420,35553,259746,95.91802068
4/11/2001,127023,102434,35458,264915,97.82680945
4/12/2001,130404,101919,35344,267667,98.84305761
4/13/2001,134264,101693,35399,271356,100.2053176
4/14/2001,137730,101307,35443,274480,101.3589365
4/15/2001,140505,100631,35319,276455,102.088257
4/16/2001,141412,99890,35294,276596,102.140325
4/17/2001,141561,99376,35234,276171,101.9833826
4/18/2001,141431,98893,35175,275499,101.735229
4/19/2001,140987,98297,35135,274419,101.3364106
4/20/2001,140634,98474,35100,274208,101.2584934
4/21/2001,140375,98217,35080,273672,101.0605613
4/22/2001,140338,98104,35165,273607,101.0365583
4/23/2001,140449,97766,35150,273365,100.9471935
4/24/2001,140505,97718,35150,273373,100.9501477
4/25/2001,140264,97589,35130,272983,100.80613
4/26/2001,140246,97508,35090,272844,100.7548006
4/27/2001,140024,97347,35026,272397,100.5897341
4/28/2001,139730,97186,35016,271932,100.4180207
4/29/2001,139418,97202,34887,271507,100.2610783
4/30/2001,139160,97090,34774,271024,100.0827179
5/1/2001,139050,96993,34665,270708,99.96602659
5/2/2001,138664,96864,34650,270178,99.77031019
5/3/2001,138351,96623,34572,269546,99.53692762
5/4/2001,138149,96430,34463,269042,99.35081241
5/5/2001,137857,96237,34384,268478,99.14254062
5/6/2001,137657,96269,34306,268232,99.05169867
5/7/2001,137181,96205,34189,267575,98.80908419
5/8/2001,136763,96237,34155,267155,98.65398818
5/9/2001,136636,96205,34023,266864,98.5465288
5/10/2001,136272,96124,33867,266263,98.3245938
5/11/2001,135982,96092,33713,265787,98.14881832
5/12/2001,135801,95706,33568,265075,97.88589365
5/13/2001,135203,95402,33529,264134,97.53840473
5/14/2001,134805,95234,33485,263524,97.31314623
5/15/2001,134390,94809,33283,262482,96.92836041
5/16/2001,133887,94444,33086,261417,96.53508124
5/17/2001,133455,93926,32914,260295,96.12075332
5/18/2001,133078,93409,32719,259206,95.71861152
5/19/2001,132541,92892,32596,258029,95.28397341
5/20/2001,132093,92329,32386,256808,94.83308715
5/21/2001,131719,91675,32274,255668,94.41211226
5/22/2001,131274,91523,32232,255029,94.17614476
5/23/2001,130954,91568,32094,254616,94.02363368
5/24/2001,130670,91523,32047,254240,93.88478582
5/25/2001,130369,91523,31939,253831,93.73375185
5/26/2001,130014,91431,31761,253206,93.50295421
5/27/2001,129837,91431,31873,253141,93.47895126
5/28/2001,129571,91553,32037,253161,93.48633678
5/29/2001,129483,91705,32108,253296,93.53618907
5/30/2001,129359,91690,32165,253214,93.50590842
5/31/2001,128919,91781,32198,252898,93.38921713
6/1/2001,128673,91827,32232,252732,93.32791728
6/2/2001,128357,92101,32377,252835,93.36595273
6/3/2001,128849,92207,32795,253851,93.74113737
6/4/2001,129060,92207,33101,254368,93.93205318
6/5/2001,129849,92527,33235,255611,94.39106352
6/6/2001,129112,92847,33408,255367,94.30096012
6/7/2001,129130,93059,33485,255674,94.41432792
6/8/2001,129359,92877,33553,255789,94.45679468
6/9/2001,129394,92923,33611,255928,94.50812408
6/10/2001,129430,92710,33654,255794,94.45864106
6/11/2001,129642,92573,33708,255923,94.5062777
6/12/2001,129571,92497,33770,255838,94.47488922
6/13/2001,129377,92344,33620,255341,94.29135894
6/14/2001,128989,91994,33441,254424,93.95273264
6/15/2001,128937,91690,33278,253905,93.76107829
6/16/2001,128655,90838,33057,252550,93.26070901
6/17/2001,129042,90747,33616,253405,93.57644018
6/18/2001,129465,90731,34243,254439,93.95827179
6/19/2001,129678,90473,34135,254286,93.90177253
6/20/2001,129837,90047,33920,253804,93.72378139
6/21/2001,129943,89804,33649,253396,93.57311669
6/22/2001,129961,89773,33283,253017,93.433161
6/23/2001,130191,89819,32995,253005,93.42872969
6/24/2001,130457,90032,32919,253408,93.57754801
6/25/2001,130741,90108,32838,253687,93.68057607
6/26/2001,130830,90047,32747,253624,93.65731167
6/27/2001,130972,89986,32643,253601,93.64881832
6/28/2001,131167,89834,32510,253511,93.61558346
6/29/2001,130777,89575,32307,252659,93.30096012
6/30/2001,130422,89302,32137,251861,93.0062777
7/1/2001,129908,89165,32023,251096,92.72378139
7/2/2001,129678,88967,32014,250659,92.56240768
7/3/2001,129306,88967,31761,250034,92.33161004
7/4/2001,129025,88906,31672,249603,92.17245199
7/5/2001,128708,88906,31583,249197,92.02252585
7/6/2001,128233,88921,31443,248597,91.80096012
7/7/2001,127723,88663,31243,247629,91.44350074
7/8/2001,127320,88602,31090,247012,91.21565731
7/9/2001,127128,88541,30975,246644,91.07976366
7/10/2001,126726,88480,30822,246028,90.85228951
7/11/2001,126132,88374,30644,245150,90.52806499
7/12/2001,125783,88343,30451,244577,90.31646972
7/13/2001,125314,88013,30273,243600,89.95568685
7/14/2001,124846,87522,30164,242532,89.56129985
7/15/2001,124447,87074,29964,241485,89.17466765
7/16/2001,124031,86756,29865,240652,88.86706056
7/17/2001,123756,86352,29760,239868,88.57754801
7/18/2001,123187,86063,29607,238857,88.20420975
7/19/2001,122756,85571,29446,237773,87.80391433
7/20/2001,122429,85094,29477,237000,87.51846381
7/21/2001,121660,84212,29473,235345,86.90731167
7/22/2001,121248,83432,29297,233977,86.4021418
7/23/2001,120855,82825,29133,232813,85.97230428
7/24/2001,120582,82232,29030,231844,85.61447563
7/25/2001,119818,81625,28870,230313,85.04911374
7/26/2001,119699,80975,28778,229452,84.73116691
7/27/2001,119240,80253,28592,228085,84.22636632
7/28/2001,118951,79465,28403,226819,83.75886263
7/29/2001,118411,78678,28224,225313,83.20273264
7/30/2001,117922,78056,28014,223992,82.71491876
7/31/2001,117484,77324,27892,222700,82.23781388
8/1/2001,116930,76661,27792,221383,81.7514771
8/2/2001,116562,76053,27507,220122,81.28581979
8/3/2001,116026,75348,27215,218589,80.71971935
8/4/2001,115542,74602,26914,217058,80.15435746
8/5/2001,115194,73887,26672,215753,79.67245199
8/6/2001,114678,73185,26452,214315,79.14143279
8/7/2001,114296,72510,26232,213038,78.66986706
8/8/2001,113700,71914,26051,211665,78.16285081
8/9/2001,113173,71331,25813,210317,77.66506647
8/10/2001,112563,70563,25542,208668,77.05612999
8/11/2001,112168,69781,25366,207315,76.55649926
8/12/2001,111889,69000,25201,206090,76.10413589
8/13/2001,111480,68364,25138,204982,75.69497784
8/14/2001,110925,67675,24998,203598,75.18389956
8/15/2001,110469,66948,24924,202341,74.71971935
8/16/2001,109786,66248,24838,200872,74.17725258
8/17/2001,109380,65650,24699,199729,73.75516987
8/18/2001,108943,64899,24556,198398,73.26366322
8/19/2001,108476,64198,24430,197104,72.78581979
8/20/2001,108040,63536,24360,195936,72.35450517
8/21/2001,107573,62734,24218,194525,71.83345643
8/22/2001,107124,62033,24063,193220,71.35155096
8/23/2001,106724,61320,23914,191958,70.88552437
8/24/2001,106340,60488,23797,190625,70.39327917
8/25/2001,105844,59560,23637,189041,69.80834564
8/26/2001,105241,58668,23561,187470,69.2282127
8/27/2001,104779,57801,23437,186017,68.69165436
8/28/2001,104272,56983,23302,184557,68.15251108
8/29/2001,103846,55994,23302,183142,67.62998523
8/30/2001,103137,55018,23171,181326,66.95937962
8/31/2001,102775,54031,22976,179782,66.38921713
9/1/2001,102492,53214,22783,178489,65.91174298
9/2/2001,101789,52409,22615,176813,65.29283604
9/3/2001,101538,51592,22466,175596,64.84342688
9/4/2001,101164,50986,22431,174581,64.46861152
9/5/2001,100652,50297,22271,173220,63.96602659
9/6/2001,100249,49445,22105,171799,63.44128508
9/7/2001,99939,48726,21919,170584,62.99261448
9/8/2001,99336,47703,21692,168731,62.30834564
9/9/2001,98813,46858,21484,167155,61.72636632
9/10/2001,98245,46112,21253,165610,61.15583456
9/11/2001,97801,45456,21070,164327,60.68205318
9/12/2001,97328,44800,20840,162968,60.18020679
9/13/2001,96810,44122,20600,161532,59.64992614
9/14/2001,96385,43622,20428,160435,59.24483013
9/15/2001,96159,42815,20399,159373,58.85265879
9/16/2001,95690,41953,20187,157830,58.28286558
9/17/2001,95040,41312,19942,156294,57.71565731
9/18/2001,94531,40430,19719,154680,57.11964549
9/19/2001,94051,39484,19482,153017,56.50553914
9/20/2001,93662,38402,19231,151295,55.86964549
9/21/2001,93258,37549,19122,149929,55.36521418
9/22/2001,92813,37004,19007,148824,54.95716396
9/23/2001,92264,36360,18832,147456,54.45199409
9/24/2001,91806,36092,18643,146541,54.11410635
9/25/2001,91482,36003,18611,146096,53.94977843
9/26/2001,91423,35786,18811,146020,53.92171344
9/27/2001,91100,35518,18672,145290,53.6521418
9/28/2001,90569,35172,18547,144288,53.28212703
9/29/2001,90059,34686,18533,143278,52.90915805
9/30/2001,89855,34052,18551,142458,52.60635155
10/1/2001,89199,33368,18544,141111,52.10893648
10/2/2001,88893,32648,18562,140103,51.73670606
10/3/2001,88533,32027,18572,139132,51.37813885
10/4/2001,87969,31267,18398,137634,50.82496307
10/5/2001,87524,30386,18261,136171,50.28471196
10/6/2001,87095,29385,18070,134550,49.68611521
10/7/2001,86480,28671,17830,132981,49.10672083
10/8/2001,86208,27945,17574,131727,48.64364845
10/9/2001,85512,27162,17342,130016,48.01181684
10/10/2001,85101,26345,17096,128542,47.46750369
10/11/2001,84594,25545,16864,127003,46.89918759
10/12/2001,84145,24694,16641,125480,46.33677991
10/13/2001,83597,23823,16407,123827,45.72636632
10/14/2001,83401,23072,16404,122877,45.37555391
10/15/2001,82997,22322,16420,121739,44.95531758
10/16/2001,82663,21649,16424,120736,44.58493353
10/17/2001,82037,20891,16447,119375,44.0823486
10/18/2001,81636,20168,16420,118224,43.65731167
10/19/2001,81374,19465,16146,116985,43.19977843
10/20/2001,80906,18761,15867,115534,42.66395864
10/21/2001,80465,17966,15857,114288,42.20384047
10/22/2001,80028,17172,15854,113054,41.74815362
10/23/2001,79469,16255,15551,111275,41.09121123
10/24/2001,79128,15451,15241,109820,40.55391433
10/25/2001,78789,14518,14923,108230,39.96676514
10/26/2001,78235,13708,14589,106532,39.33973412
10/27/2001,77789,13011,14262,105062,38.79689808
10/28/2001,77212,12257,13936,103405,38.18500739
10/29/2001,76662,11475,13607,101744,37.57163959
10/30/2001,75984,10726,13559,100269,37.02695716
10/31/2001,75241,10269,13358,98868,36.50960118
11/1/2001,74675,9787,13147,97609,36.04468242
11/2/2001,73901,9299,12960,96160,35.50960118
11/3/2001,73445,8816,12775,95036,35.09453471
11/4/2001,72626,8374,12568,93568,34.55243722
11/5/2001,72033,7950,12560,92543,34.1739291
11/6/2001,71211,7567,12551,91329,33.72562777
11/7/2001,70485,7288,12537,90310,33.3493353
11/8/2001,69801,7075,12522,89398,33.01255539
11/9/2001,68920,6765,12520,88205,32.57200886
11/10/2001,67933,6521,12511,86965,32.11410635
11/11/2001,67188,6330,12482,86000,31.7577548
11/12/2001,66252,6129,12511,84892,31.34859675
11/13/2001,65507,5952,12508,83967,31.00701625
11/14/2001,64583,5816,12479,82878,30.60487445
11/15/2001,63629,5571,12488,81688,30.16543575
11/16/2001,62827,5379,12488,80694,29.79837518
11/17/2001,62066,5100,12453,79619,29.40140325
11/18/2001,61156,4881,12320,78357,28.93537666
11/19/2001,60346,4666,12187,77199,28.5077548
11/20/2001,59565,4425,12057,76047,28.0823486
11/21/2001,58709,4180,11913,74802,27.6225997
11/22/2001,57926,3946,11806,73678,27.20753323
11/23/2001,56978,3699,11656,72333,26.71085672
11/24/2001,56082,3446,11515,71043,26.2344904
11/25/2001,55337,3284,11394,70015,25.85487445
11/26/2001,54686,3245,11336,69267,25.57865583
11/27/2001,53859,3294,11276,68429,25.26920236
11/28/2001,53325,3355,11172,67852,25.05612999
11/29/2001,52729,3414,11104,67247,24.83271787
11/30/2001,51915,3472,11019,66406,24.52215657
12/1/2001,51280,3547,11183,66010,24.37592319
12/2/2001,51215,3699,11360,66274,24.47341211
12/3/2001,50726,3835,11479,66040,24.38700148
12/4/2001,50412,3952,11548,65912,24.33973412
12/5/2001,50292,4060,11631,65983,24.36595273
12/6/2001,49979,4144,11704,65827,24.30834564
12/7/2001,49537,4196,11762,65495,24.18574594
12/8/2001,49096,4238,11798,65132,24.05169867
12/9/2001,48679,4335,11837,64851,23.94793205
12/10/2001,48124,4410,11888,64422,23.78951256
12/11/2001,47711,4482,11921,64114,23.67577548
12/12/2001,47351,4538,11963,63852,23.57902511
12/13/2001,47002,4614,12031,63647,23.50332349
12/14/2001,46676,4693,12090,63459,23.43389956
12/15/2001,46310,4806,12232,63348,23.3929099
12/16/2001,46436,4912,12263,63611,23.49002954
12/17/2001,46467,5062,12275,63804,23.56129985
12/18/2001,46540,5315,12352,64207,23.71011817
12/19/2001,47034,5760,12537,65331,24.12518464
12/20/2001,47150,6186,12614,65950,24.35376662
12/21/2001,47340,6574,12696,66610,24.59748892
12/22/2001,47584,6870,12701,67155,24.79874446
12/23/2001,47837,7153,12701,67691,24.99667651
12/24/2001,48071,7431,12722,68224,25.19350074
12/25/2001,48317,7715,12730,68762,25.39217134
12/26/2001,48295,7985,12758,69038,25.49409158
12/27/2001,48231,8202,12752,69185,25.54837518
12/28/2001,48242,8350,12687,69279,25.58308715
12/29/2001,48103,8552,12722,69377,25.61927622
12/30/2001,48359,8765,12611,69735,25.7514771
12/31/2001,48433,8913,12557,69903,25.81351551
1/1/2002,48285,9030,12470,69785,25.76994092
1/2/2002,48156,9136,12363,69655,25.72193501
1/3/2002,48145,9294,12277,69716,25.74446086
1/4/2002,47848,9421,12235,69504,25.6661743
1/5/2002,47701,9578,12110,69389,25.62370753
1/6/2002,47520,9705,12116,69341,25.60598227
1/7/2002,47182,9827,12071,69080,25.50960118
1/8/2002,47034,9969,12082,69085,25.51144756
1/9/2002,46876,10081,12051,69008,25.48301329
1/10/2002,46939,10249,11955,69143,25.53286558
1/11/2002,46729,10401,11941,69071,25.5062777
1/12/2002,46373,10533,11896,68802,25.40694239
1/13/2002,46487,10701,11952,69140,25.53175775
1/14/2002,46708,10767,11988,69463,25.65103397
1/15/2002,46404,10916,12026,69346,25.60782866
1/16/2002,46352,11020,12076,69448,25.64549483
1/17/2002,46215,11170,12113,69498,25.66395864
1/18/2002,46173,11291,12153,69617,25.70790251
1/19/2002,45849,11383,12195,69427,25.63774003
1/20/2002,46037,11475,12135,69647,25.7189808
1/21/2002,46089,11584,12085,69758,25.75997046
1/22/2002,45828,11694,12031,69553,25.68426883
1/23/2002,45787,11831,11972,69590,25.69793205
1/24/2002,45579,11952,11930,69461,25.65029542
1/25/2002,45745,12223,11916,69884,25.80649926
1/26/2002,45870,12776,11874,70520,26.04135894
1/27/2002,46142,13282,11840,71264,26.31610044
1/28/2002,46634,13725,11815,72174,26.6521418
1/29/2002,46624,14241,11773,72638,26.82348597
1/30/2002,47150,14910,11804,73864,27.27621861
1/31/2002,48178,16384,11966,76528,28.25997046
2/1/2002,49074,17579,11958,78611,29.02917282
2/2/2002,50313,19240,12150,81703,30.17097489
2/3/2002,51565,20906,12260,84731,31.28914328
2/4/2002,52674,22136,12323,87133,32.17614476
2/5/2002,53104,22948,12323,88375,32.63478582
2/6/2002,53469,23738,12272,89479,33.04246677
2/7/2002,53771,24279,12145,90195,33.30686854
2/8/2002,54004,25009,12085,91098,33.64032496
2/9/2002,54193,25741,11994,91928,33.94682422
2/10/2002,54271,26285,11907,92463,34.144387
2/11/2002,54989,27009,11949,93947,34.69239291
2/12/2002,55968,28566,12051,96585,35.66654357
2/13/2002,56648,29533,12031,98212,36.26735598
2/14/2002,56955,30340,11963,99258,36.65361891
2/15/2002,57344,30942,11935,100221,37.00923191
2/16/2002,57446,31434,11983,100863,37.24630724
2/17/2002,57767,31971,12015,101753,37.57496307
2/18/2002,57881,32398,12009,102288,37.77252585
2/19/2002,58052,32759,11998,102809,37.96491876
2/20/2002,58190,32935,12023,103148,38.0901034
2/21/2002,58294,33111,12037,103442,38.19867061
2/22/2002,58364,33408,12170,103942,38.38330871
2/23/2002,58490,33556,12277,104323,38.52400295
2/24/2002,58548,33794,12380,104722,38.67134417
2/25/2002,58720,33973,12467,105160,38.83308715
2/26/2002,58743,34220,12554,105517,38.96491876
2/27/2002,59009,34399,12640,106048,39.16100443
2/28/2002,59066,34656,12707,106429,39.30169867
3/1/2002,58997,34706,12798,106501,39.32828656
3/2/2002,58962,34775,12866,106603,39.36595273
3/3/2002,59112,35013,12883,107008,39.5155096
3/4/2002,59577,35191,13034,107802,39.80871492
3/5/2002,59891,35301,13084,108276,39.98375185
3/6/2002,60147,35380,13096,108623,40.11189069
3/7/2002,60439,35499,13114,109052,40.27031019
3/8/2002,60991,35409,13117,109517,40.44202363
3/9/2002,61179,35469,13135,109783,40.54025111
3/10/2002,61652,35607,13158,110417,40.77437223
3/11/2002,62172,35677,13349,111198,41.06277696
3/12/2002,62480,35766,13436,111682,41.24150665
3/13/2002,62851,35855,13475,112181,41.42577548
3/14/2002,63174,35914,13421,112509,41.54689808
3/15/2002,63593,36033,13559,113185,41.7965288
3/16/2002,64087,36122,13598,113807,42.02621861
3/17/2002,64438,36152,13680,114270,42.1971935
3/18/2002,64958,36231,13783,114972,42.45642541
3/19/2002,64982,36291,13828,115101,42.50406204
3/20/2002,65311,36370,13850,115531,42.66285081
3/21/2002,65408,36459,13899,115766,42.74963072
3/22/2002,65910,36608,13984,116502,43.02141802
3/23/2002,66118,36707,13988,116813,43.13626292
3/24/2002,66571,36816,14003,117390,43.3493353
3/25/2002,66941,36855,14006,117802,43.5014771
3/26/2002,67101,37014,14012,118127,43.62149188
3/27/2002,68071,38391,14299,120761,44.59416544
3/28/2002,69399,41060,14734,125193,46.23079764
3/29/2002,70575,42668,14968,128211,47.34527326
3/30/2002,71365,44033,15238,130636,48.24076809
3/31/2002,72445,45212,15690,133347,49.24187592
4/1/2002,73419,46424,16070,135913,50.1894387
4/2/2002,73993,47491,16401,137885,50.9176514
4/3/2002,74491,48348,16661,139500,51.5140325
4/4/2002,74925,49107,16927,140959,52.0528065
4/5/2002,75453,49784,17137,142374,52.57533235
4/6/2002,75666,50274,17302,143242,52.89586411
4/7/2002,76263,50799,17491,144553,53.37998523
4/8/2002,76770,51149,17646,145565,53.75369276
4/9/2002,76890,51534,17795,146219,53.99519941
4/10/2002,77078,51896,17942,146916,54.25258493
4/11/2002,77320,52257,18063,147640,54.51994092
4/12/2002,77360,52584,18186,148130,54.70088626
4/13/2002,77561,52840,18317,148718,54.91802068
4/14/2002,77977,53284,18501,149762,55.30354505
4/15/2002,78735,53774,18803,151312,55.87592319
4/16/2002,79496,54626,19224,153346,56.62703102
4/17/2002,80110,55433,19405,154948,57.21861152
4/18/2002,80657,56068,19558,156283,57.71159527
4/19/2002,81071,56678,19639,157388,58.11964549
4/20/2002,81512,57118,19836,158466,58.51772526
4/21/2002,82065,57496,19961,159522,58.90768095
4/22/2002,82343,57765,20109,160217,59.16432792
4/23/2002,82385,57911,20198,160494,59.26661743
4/24/2002,82677,58107,20164,160948,59.43426883
4/25/2002,82761,58253,20127,161141,59.50553914
4/26/2002,83192,58546,20098,161836,59.76218612
4/27/2002,83583,58790,20231,162604,60.04579025
4/28/2002,83710,58986,20379,163075,60.21971935
4/29/2002,84355,59645,20859,164859,60.87850812
4/30/2002,85017,60659,21196,166872,61.62186115
5/1/2002,86251,61791,21363,169405,62.55723781
5/2/2002,87266,63014,21477,171757,63.42577548
5/3/2002,88345,63994,21908,174247,64.34527326
5/4/2002,89199,64682,22221,176102,65.03028065
5/5/2002,89942,65306,22455,177703,65.62149188
5/6/2002,90687,65675,22678,179040,66.11521418
5/7/2002,91144,66134,22859,180137,66.52031019
5/8/2002,91629,66490,23044,181163,66.89918759
5/9/2002,92219,66796,23211,182226,67.29172821
5/10/2002,92397,67037,23302,182736,67.48005908
5/11/2002,92679,67292,23326,183297,67.68722304
5/12/2002,92784,67397,23358,183539,67.77658789
5/13/2002,93527,67834,23441,184802,68.24298375
5/14/2002,94516,69000,23983,187499,69.23892171
5/15/2002,95886,70709,24397,190992,70.52880355
5/16/2002,97176,71953,24645,193774,71.55612999
5/17/2002,98030,72960,24912,195902,72.34194978
5/18/2002,99075,73967,25142,198184,73.18463811
5/19/2002,100497,75749,25542,201788,74.5155096
5/20/2002,101633,77075,25800,204508,75.51994092
5/21/2002,102601,78166,26009,206776,76.35745938
5/22/2002,103326,79037,26202,208565,77.01809453
5/23/2002,104161,79783,26372,210316,77.66469719
5/24/2002,104923,80322,26515,211760,78.19793205
5/25/2002,105494,80778,26693,212965,78.6429099
5/26/2002,106036,81148,26846,214030,79.03618907
5/27/2002,106436,81409,26970,214815,79.3260709
5/28/2002,107525,81813,27094,216432,79.92319055
5/29/2002,108201,82651,27227,218079,80.53138848
5/30/2002,108765,82955,27356,219076,80.89955687
5/31/2002,109218,83244,27520,219982,81.23412112
6/1/2002,110241,83909,27862,222012,81.98375185
6/2/2002,110843,84328,28040,223211,82.42651403
6/3/2002,111154,84444,28127,223725,82.61632201
6/4/2002,111694,84458,28233,224385,82.86004431
6/5/2002,112152,84545,28373,225070,83.11299852
6/6/2002,112695,84632,28557,225884,83.41358936
6/7/2002,114031,86063,28977,229071,84.59047267
6/8/2002,115559,86178,29351,231088,85.33530281
6/9/2002,116595,86626,29571,232792,85.96454948
6/10/2002,117467,86915,29756,234138,86.46159527
6/11/2002,117905,87334,29919,235158,86.83825702
6/12/2002,118613,87320,30064,235997,87.14807976
6/13/2002,119291,87378,30128,236797,87.44350074
6/14/2002,119580,87421,30241,237242,87.60782866
6/15/2002,120021,87666,30369,238056,87.9084195
6/16/2002,120718,88086,30570,239374,88.39512555
6/17/2002,121282,88724,30799,240805,88.92355982
6/18/2002,121780,89241,30928,241949,89.34601182
6/19/2002,122104,89408,31039,242551,89.5683161
6/20/2002,122498,89393,31053,242944,89.71344165
6/21/2002,122705,89210,31122,243037,89.74778434
6/22/2002,122722,89043,31202,242967,89.72193501
6/23/2002,123067,88769,31202,243038,89.74815362
6/24/2002,123549,88769,31266,243584,89.94977843
6/25/2002,123462,88480,31211,243153,89.79062038
6/26/2002,123411,88115,31127,242653,89.60598227
6/27/2002,123445,87826,31039,242310,89.47932053
6/28/2002,123497,87508,30928,241933,89.3401034
6/29/2002,123566,87435,30813,241814,89.29615953
6/30/2002,123756,87204,30758,241718,89.26070901
7/1/2002,123635,86915,30630,241180,89.0620384
7/2/2002,123497,86568,30451,240516,88.816839
7/3/2002,123170,86091,30350,239611,88.48264402
7/4/2002,122722,85600,30200,238522,88.08050222
7/5/2002,122429,85253,30068,237750,87.79542097
7/6/2002,121985,84704,29946,236635,87.38367799
7/7/2002,121660,84299,29814,235773,87.06536189
7/8/2002,121265,83836,29638,234739,86.68353028
7/9/2002,120821,83374,29527,233722,86.30797637
7/10/2002,120293,82940,29338,232571,85.88293944
7/11/2002,119665,82550,29231,231446,85.46750369
7/12/2002,119359,82102,29114,230575,85.14586411
7/13/2002,118917,81495,28884,229296,84.67355982
7/14/2002,118495,80932,28760,228187,84.2640325
7/15/2002,118158,80488,28685,227331,83.94793205
7/16/2002,117635,80101,28539,226275,83.55797637
7/17/2002,116981,79548,28337,224866,83.03766617
7/18/2002,116730,79078,28093,223901,82.68131462
7/19/2002,116110,78567,27896,222573,82.19091581
7/20/2002,115893,77890,27675,221458,81.77917282
7/21/2002,115393,77282,27602,220277,81.34305761
7/22/2002,114878,76730,27524,219132,80.92023634
7/23/2002,114313,76150,27288,217751,80.41026588
7/24/2002,114113,75500,26979,216592,79.98227474
7/25/2002,113535,75086,26974,215595,79.61410635
7/26/2002,112991,74409,26945,214345,79.15251108
7/27/2002,112745,73569,26881,213195,78.72784343
7/28/2002,112234,72828,26838,211900,78.24963072
7/29/2002,111873,72245,26808,210926,77.88995569
7/30/2002,111464,71755,26680,209899,77.51070901
7/31/2002,110974,71225,26545,208744,77.08419498
8/1/2002,110273,70536,26384,207193,76.51144756
8/2/2002,109883,69861,26190,205934,76.0465288
8/3/2002,109608,69172,26068,204848,75.64549483
8/4/2002,109429,68457,26030,203916,75.30132939
8/5/2002,109024,67556,25921,202501,74.77880355
8/6/2002,108508,66770,25620,200898,74.18685377
8/7/2002,108136,65930,25570,199636,73.72082718
8/8/2002,107750,65077,25437,198264,73.21418021
8/9/2002,107156,64173,25271,196600,72.59970458
8/10/2002,106596,63179,25073,194848,71.95273264
8/11/2002,106116,62186,24936,193238,71.35819793
8/12/2002,105701,61218,24797,191716,70.79615953
8/13/2002,105129,60475,24507,190111,70.2034712
8/14/2002,104526,59340,24209,188075,69.45162482
8/15/2002,104114,58314,24003,186431,68.84453471
8/16/2002,103500,57289,23757,184546,68.14844904
8/17/2002,103011,56202,23549,182762,67.48966027
8/18/2002,102853,55127,23441,181421,66.99446086
8/19/2002,102227,54217,23334,179778,66.38774003
8/20/2002,101617,53237,23135,177989,65.72710487
8/21/2002,101289,52164,22929,176382,65.13367799
8/22/2002,100761,51184,22669,174614,64.48079764
8/23/2002,99970,50251,22529,172750,63.79246677
8/24/2002,99645,49352,22334,171331,63.26846381
8/25/2002,99274,48436,22186,169896,62.73855244
8/26/2002,98721,48003,22101,168825,62.34305761
8/27/2002,98275,47258,21973,167506,61.85598227
8/28/2002,97786,46602,21811,166199,61.37333826
8/29/2002,97343,45834,21660,164837,60.87038405
8/30/2002,97191,45401,21707,164299,60.67171344
8/31/2002,96719,44711,21660,163090,60.22525849
9/1/2002,96114,43955,21680,161749,59.73005908
9/2/2002,95750,43435,21641,160826,59.38921713
9/3/2002,95297,42878,21588,159763,58.99667651
9/4/2002,95086,42426,21603,159115,58.75738552
9/5/2002,94441,41816,21561,157818,58.27843427
9/6/2002,93991,41176,21511,156678,57.85745938
9/7/2002,93647,40262,21496,155405,57.38737075
9/8/2002,93185,39432,21355,153972,56.85819793
9/9/2002,92754,38896,21150,152800,56.4254062
9/10/2002,92131,38318,20919,151368,55.89660266
9/11/2002,91555,37757,20773,150085,55.42282127
9/12/2002,91129,37123,20622,148874,54.97562777
9/13/2002,90643,36608,20544,147795,54.57717873
9/14/2002,90190,36073,20443,146706,54.17503693
9/15/2002,89577,35518,20309,145404,53.69423929
9/16/2002,89418,35251,20272,144941,53.5232644
9/17/2002,88864,34904,20213,143981,53.16875923
9/18/2002,88460,34557,20124,143141,52.85856721
9/19/2002,88056,34320,19954,142330,52.55908419
9/20/2002,87466,34072,19840,141378,52.20753323
9/21/2002,86837,33725,19690,140252,51.79172821
9/22/2002,86551,33616,19544,139711,51.59194978
9/23/2002,86193,33973,19428,139594,51.54874446
9/24/2002,85625,34101,19293,139019,51.33641064
9/25/2002,85328,34091,19202,138621,51.1894387
9/26/2002,84834,33903,19054,137791,50.88293944
9/27/2002,84355,33963,18928,137246,50.6816839
9/28/2002,83990,34220,19122,137332,50.71344165
9/29/2002,83864,34448,19174,137486,50.77031019
9/30/2002,83359,34607,19086,137052,50.61004431
10/1/2002,82928,34696,19003,136627,50.45310192
10/2/2002,82761,34716,18903,136380,50.36189069
10/3/2002,82469,34765,18740,135974,50.21196455
10/4/2002,81912,34666,18664,135242,49.94165436
10/5/2002,81622,34567,18625,134814,49.78360414
10/6/2002,81099,34429,18625,134153,49.53951256
10/7/2002,80479,34220,18593,133292,49.22156573
10/8/2002,79933,34032,18504,132469,48.9176514
10/9/2002,79578,33745,18412,131735,48.64660266
10/10/2002,79114,33487,18345,130946,48.35524372
10/11/2002,78641,33186,18179,130006,48.00812408
10/12/2002,78545,33378,18363,130286,48.11152142
10/13/2002,78978,34181,19147,132306,48.85745938
10/14/2002,79032,34785,19464,133281,49.21750369
10/15/2002,78924,35221,19580,133725,49.38146233
10/16/2002,78992,35578,19730,134300,49.59379616
10/17/2002,80837,37311,20517,138665,51.20568685
10/18/2002,82357,39463,20946,142766,52.72008863
10/19/2002,83359,40777,21218,145354,53.67577548
10/20/2002,84089,41806,21386,147281,54.38737075
10/21/2002,84735,42605,21550,148890,54.98153619
10/22/2002,85074,43288,21699,150061,55.41395864
10/23/2002,85456,43900,21803,151159,55.81942393
10/24/2002,85825,44367,21896,152088,56.16248154
10/25/2002,86023,44556,21992,152571,56.34084195
10/26/2002,86165,44734,22108,153007,56.50184638
10/27/2002,86680,45078,22361,154119,56.91248154
10/28/2002,87066,45334,22513,154913,57.20568685
10/29/2002,87209,45501,22630,155340,57.3633678
10/30/2002,87309,45623,22721,155653,57.47895126
10/31/2002,87366,45746,22807,155919,57.57717873
11/1/2002,87409,45757,22901,156067,57.63183161
11/2/2002,87452,45868,22973,156293,57.71528804
11/3/2002,87753,45923,23040,156716,57.87149188
11/4/2002,88042,46012,23107,157161,58.03581979
11/5/2002,88215,45879,23167,157261,58.07274742
11/6/2002,88562,46035,23282,157879,58.30096012
11/7/2002,88922,46101,23445,158468,58.51846381
11/8/2002,89199,46246,23545,158990,58.711226
11/9/2002,89447,46346,23513,159306,58.82791728
11/10/2002,89403,46680,23437,159520,58.90694239
11/11/2002,89374,47124,23350,159848,59.02806499
11/12/2002,89432,47402,23314,160148,59.13884786
11/13/2002,89782,47958,23358,161098,59.48966027
11/14/2002,90117,48759,23385,162261,59.91912851
11/15/2002,90438,49387,23413,163238,60.27991137
11/16/2002,90672,50029,23405,164106,60.60044313
11/17/2002,91217,50811,23521,165549,61.13330871
11/18/2002,92175,52024,23947,168146,62.09231905
11/19/2002,92694,53202,24169,170065,62.80096012
11/20/2002,93243,54206,24271,171720,63.41211226
11/21/2002,93767,55201,24413,173381,64.02548006
11/22/2002,94516,56324,24417,175257,64.71824225
11/23/2002,95629,57606,24674,177909,65.69756278
11/24/2002,96977,59206,24969,181152,66.89512555
11/25/2002,98092,60524,25189,183805,67.87481536
11/26/2002,99075,61511,25379,185965,68.67245199
11/27/2002,99908,62505,25525,187938,69.40103397
11/28/2002,100668,63332,25699,189699,70.05132939
11/29/2002,101258,64096,25825,191179,70.5978582
11/30/2002,101664,64835,25942,192441,71.06388479
12/1/2002,102163,65510,26072,193745,71.54542097
12/2/2002,102601,66057,26165,194823,71.94350074
12/3/2002,103011,66554,26261,195826,72.31388479
12/4/2002,103042,66923,26190,196155,72.43537666
12/5/2002,103074,67292,26123,196489,72.55871492
12/6/2002,103105,67649,26093,196847,72.69091581
12/7/2002,103090,68351,26018,197459,72.91691285
12/8/2002,103058,68682,25963,197703,73.00701625
12/9/2002,103011,69040,25913,197964,73.10339734
12/10/2002,102869,69225,25821,197915,73.08530281
12/11/2002,102759,69384,25733,197876,73.07090103
12/12/2002,102853,69742,25703,198298,73.2267356
12/13/2002,102822,70152,25633,198607,73.34084195
12/14/2002,102869,70642,25587,199098,73.52215657
12/15/2002,103105,71278,25620,200003,73.85635155
12/16/2002,103294,72033,25587,200914,74.19276219
12/17/2002,103404,72576,25574,201554,74.42909897
12/18/2002,103420,73013,25483,201916,74.56277696
12/19/2002,103484,73450,25379,202313,74.70937962
12/20/2002,103594,74022,25333,202949,74.94423929
12/21/2002,105209,75804,25733,206746,76.34638109
12/22/2002,106292,77421,25900,209613,77.40509601
12/23/2002,107108,78664,26030,211802,78.21344165
12/24/2002,107734,79686,26118,213538,78.85450517
12/25/2002,108217,80557,26236,215010,79.39807976
12/26/2002,109137,81770,26409,217316,80.24963072
12/27/2002,109770,82579,26536,218885,80.82902511
12/28/2002,110338,83056,26651,220045,81.25738552
12/29/2002,110827,83735,26769,221331,81.73227474
12/30/2002,111317,84400,26868,222585,82.19534712
12/31/2002,111726,84921,26988,223635,82.58308715
1/1/2003,112283,85571,27124,224978,83.07902511
1/2/2003,113453,86655,27503,227611,84.05132939
1/3/2003,114363,87739,27849,229951,84.91543575
1/4/2003,115210,88663,28084,231957,85.65620384
1/5/2003,115959,89545,28263,233767,86.3245938
1/6/2003,116578,90382,28434,235394,86.9254062
1/7/2003,117048,91112,28579,236739,87.42208272
1/8/2003,117467,91797,28716,237980,87.88035451
1/9/2003,117905,92420,28852,239177,88.32237814
1/10/2003,118377,93014,28972,240363,88.76033973
1/11/2003,118344,93668,29110,241122,89.04062038
1/12/2003,118276,94276,29226,241778,89.28286558
1/13/2003,118124,94763,29325,242212,89.44313146
1/14/2003,117989,95067,29424,242480,89.54209749
1/15/2003,117669,95326,29491,242486,89.54431315
1/16/2003,117417,95539,29572,242528,89.55982275
1/17/2003,117199,95996,29643,242838,89.67429838
1/18/2003,116947,96286,29720,242953,89.71676514
1/19/2003,117098,96382,29769,243249,89.8260709
1/20/2003,117316,96575,29850,243741,90.0077548
1/21/2003,117467,96639,29914,244020,90.11078287
1/22/2003,117702,96671,29986,244359,90.2359675
1/23/2003,117854,96687,29964,244505,90.28988183
1/24/2003,117972,96623,29910,244505,90.28988183
1/25/2003,117854,96559,29810,244223,90.18574594
1/26/2003,117619,96575,29692,243886,90.06129985
1/27/2003,117383,96639,29563,243585,89.95014771
1/28/2003,117132,96623,29450,243205,89.80982275
1/29/2003,116914,96575,29293,242782,89.65361891
1/30/2003,116695,96511,29164,242370,89.5014771
1/31/2003,116394,96559,29012,241965,89.35192024
2/1/2003,116144,96543,28870,241557,89.20125554
2/2/2003,115892,96527,28795,241214,89.0745938
2/3/2003,115625,96494,28716,240835,88.93463811
2/4/2003,115459,96559,28588,240606,88.85007386
2/5/2003,115442,96704,28557,240703,88.88589365
2/6/2003,115310,96816,28398,240524,88.81979321
2/7/2003,115160,96655,28207,240022,88.63441654
2/8/2003,115061,96430,28084,239575,88.46935007
2/9/2003,114745,96511,27931,239187,88.3260709
2/10/2003,114562,96623,27774,238959,88.24187592
2/11/2003,114329,96671,27606,238606,88.11152142
2/12/2003,114097,96687,27498,238282,87.99187592
2/13/2003,113915,96655,27292,237862,87.83677991
2/14/2003,113650,96366,27077,237093,87.5528065
2/15/2003,113470,96173,26949,236592,87.36779911
2/16/2003,113091,95996,26842,235929,87.12296898
2/17/2003,112794,96157,26770,235721,87.04615953
2/18/2003,112580,96302,26676,235558,86.9859675
2/19/2003,112267,96398,26557,235222,86.86189069
2/20/2003,111972,96463,26566,235001,86.78028065
2/21/2003,112086,96495,26604,235185,86.84822747
2/22/2003,112267,96511,26638,235416,86.93353028
2/23/2003,112564,96703,26762,236029,87.1598966
2/24/2003,113091,96977,26923,236991,87.51514032
2/25/2003,113486,97267,27035,237788,87.80945347
2/26/2003,113816,97283,27098,238197,87.96048744
2/27/2003,113865,97267,27163,238295,87.99667651
2/28/2003,113997,96977,27133,238107,87.92725258
3/1/2003,114030,96671,27128,237829,87.8245938
3/2/2003,114047,96527,27206,237780,87.80649926
3/3/2003,114163,96478,27356,237997,87.8866322
3/4/2003,114030,96414,27202,237646,87.75701625
3/5/2003,114080,96382,27172,237634,87.75258493
3/6/2003,114147,96317,27107,237571,87.72932053
3/7/2003,114213,96317,27026,237556,87.72378139
3/8/2003,114246,96301,27116,237663,87.76329394
3/9/2003,114296,96237,27206,237739,87.79135894
3/10/2003,114279,96189,27275,237743,87.79283604
3/11/2003,114163,96221,27326,237710,87.78064993
3/12/2003,114130,96221,27412,237763,87.80022157
3/13/2003,114113,96269,27485,237867,87.83862629
3/14/2003,114097,96237,27503,237837,87.82754801
3/15/2003,113865,96173,27563,237601,87.74039882
3/16/2003,113849,96350,27653,237852,87.83308715
3/17/2003,114196,96559,27792,238547,88.08973412
3/18/2003,115293,97830,28114,241237,89.08308715
3/19/2003,117249,99070,28650,244969,90.461226
3/20/2003,119053,99730,29052,247835,91.51957164
3/21/2003,122378,101178,30027,253583,93.64217134
3/22/2003,127233,103447,31860,262540,96.94977843
3/23/2003,130865,103511,32995,267371,98.73375185
3/24/2003,133527,102208,33374,269109,99.37555391
3/25/2003,135602,101210,33828,270640,99.94091581
3/26/2003,137528,100663,34350,272541,100.6429099
3/27/2003,139271,100389,34926,274586,101.3980798
3/28/2003,140449,99955,35165,275569,101.7610783
3/29/2003,141227,99521,35184,275932,101.8951256
3/30/2003,142193,99730,35359,277282,102.3936484
3/31/2003,142174,99762,35234,277170,102.3522895
4/1/2003,141839,99472,35179,276490,102.1011817
4/2/2003,141672,99167,35189,276028,101.9305761
4/3/2003,141672,99054,35174,275900,101.8833087
4/4/2003,141616,98893,35174,275683,101.8031758
4/5/2003,141635,98989,35165,275789,101.8423191
4/6/2003,141616,99102,35145,275863,101.8696455
4/7/2003,141579,99070,35135,275784,101.8404727
4/8/2003,141560,98845,35125,275530,101.7466765
4/9/2003,141245,98667,35120,275032,101.562777
4/10/2003,140950,98539,35120,274609,101.4065731
4/11/2003,140820,98249,35115,274184,101.2496307
4/12/2003,140838,98088,35155,274081,101.2115953
4/13/2003,140820,97959,35160,273939,101.1591581
4/14/2003,140783,97846,35150,273779,101.1000739
4/15/2003,140764,97653,34971,273388,100.9556869
4/16/2003,140727,97637,34877,273241,100.9014032
4/17/2003,140727,97589,34715,273031,100.8238552
4/18/2003,140653,97412,34630,272695,100.6997784
4/19/2003,140653,97267,34492,272412,100.5952733
4/20/2003,140542,97202,34340,272084,100.4741507
4/21/2003,140449,97090,34194,271733,100.3445347
4/22/2003,140449,97041,34013,271503,100.2596012
4/23/2003,140579,97025,33979,271583,100.2891433
4/24/2003,140597,96993,33983,271573,100.2854505
4/25/2003,140375,97057,33886,271318,100.1912851
4/26/2003,140356,96993,33784,271133,100.122969
4/27/2003,140690,97653,33760,272103,100.4811669
4/28/2003,140764,97943,33760,272467,100.6155835
4/29/2003,140746,98007,33615,272368,100.5790251
4/30/2003,140764,97927,33528,272219,100.524003
5/1/2003,140709,97814,33393,271916,100.4121123
5/2/2003,141431,97701,33211,272343,100.5697932
5/3/2003,142267,98023,33158,273448,100.9778434
5/4/2003,142136,97959,33129,273224,100.8951256
5/5/2003,141894,97798,33081,272773,100.728582
5/6/2003,141764,97621,32972,272357,100.5749631
5/7/2003,141431,97492,33048,271971,100.4324225
5/8/2003,140950,97347,33115,271412,100.225997
5/9/2003,140820,97154,33168,271142,100.1262925
5/10/2003,140672,97025,33235,270932,100.0487445
5/11/2003,140523,96864,33317,270704,99.96454948
5/12/2003,140783,96880,33485,271148,100.1285081
5/13/2003,140913,96977,33635,271525,100.2677253
5/14/2003,140913,97186,33765,271864,100.3929099
5/15/2003,140875,97347,33803,272025,100.4523634
5/16/2003,140764,97379,33896,272039,100.4575332
5/17/2003,140727,97363,33979,272069,100.4686115
5/18/2003,140672,97331,34072,272075,100.4708272
5/19/2003,140560,97218,34160,271938,100.4202363
5/20/2003,140486,97122,34228,271836,100.3825702
5/21/2003,140375,97073,34311,271759,100.3541359
5/22/2003,140319,96977,34301,271597,100.2943131
5/23/2003,140172,96671,34370,271213,100.1525111
5/24/2003,140024,96623,34399,271046,100.0908419
5/25/2003,139896,96735,34517,271148,100.1285081
5/26/2003,139748,96784,34635,271167,100.1355244
5/27/2003,139748,96848,34788,271384,100.2156573
5/28/2003,139859,96880,34808,271547,100.2758493
5/29/2003,140024,96864,34724,271612,100.2998523
5/30/2003,140338,96832,34798,271968,100.4313146
5/31/2003,140523,96800,34917,272240,100.5317578
6/1/2003,140950,96945,35189,273084,100.8434269
6/2/2003,141431,97347,35299,274077,101.2101182
6/3/2003,141505,97460,35189,274154,101.2385524
6/4/2003,141468,97492,35155,274115,101.2241507
6/5/2003,141412,97460,35140,274012,101.1861152
6/6/2003,141319,97428,35120,273867,101.1325702
6/7/2003,141005,97363,35085,273453,100.9796898
6/8/2003,140913,97363,34956,273232,100.8980798
6/9/2003,140727,97331,34843,272901,100.7758493
6/10/2003,140653,97251,34863,272767,100.7263663
6/11/2003,140783,97025,34793,272601,100.6650665
6/12/2003,140894,97057,34759,272710,100.7053176
6/13/2003,141098,97170,34936,273204,100.88774
6/14/2003,141245,97669,35120,274034,101.1942393
6/15/2003,141412,98426,35110,274948,101.5317578
6/16/2003,141375,98426,35080,274881,101.5070162
6/17/2003,141079,98249,34986,274314,101.2976366
6/18/2003,140838,98040,34931,273809,101.1111521
6/19/2003,140709,97862,34877,273448,100.9778434
6/20/2003,140560,97685,34803,273048,100.8301329
6/21/2003,140783,97846,34788,273417,100.9663959
6/22/2003,141079,98136,34833,274048,101.1994092
6/23/2003,141319,98345,34981,274645,101.4198671
6/24/2003,141098,98265,34936,274299,101.2920975
6/25/2003,140950,98072,34892,273914,101.1499261
6/26/2003,140838,97701,34818,273357,100.9442393
6/27/2003,140616,97186,34700,272502,100.6285081
6/28/2003,140468,96864,34675,272007,100.4457164
6/29/2003,140227,96623,34630,271480,100.2511078
6/30/2003,140024,96350,34596,270970,100.062777
7/1/2003,139822,96109,34552,270483,99.88293944
7/2/2003,139565,95722,34492,269779,99.62296898
7/3/2003,139271,95387,34448,269106,99.37444609
7/4/2003,139032,95113,34355,268500,99.1506647
7/5/2003,138866,94992,34306,268164,99.02658789
7/6/2003,138793,94778,34282,267853,98.91174298
7/7/2003,138480,94489,34155,267124,98.64254062
7/8/2003,138406,94200,34106,266712,98.49039882
7/9/2003,138150,93653,34033,265836,98.16691285
7/10/2003,137894,93349,34130,265373,97.99593796
7/11/2003,137637,93272,34037,264946,97.83825702
7/12/2003,137802,93759,33920,265481,98.03581979
7/13/2003,137930,93820,33969,265719,98.12370753
7/14/2003,138003,93683,33993,265679,98.10893648
7/15/2003,137820,93471,33925,265216,97.9379616
7/16/2003,137656,93181,33833,264670,97.73633678
7/17/2003,137510,92862,33741,264113,97.53064993
7/18/2003,137182,92512,33688,263382,97.26070901
7/19/2003,136926,92284,33586,262796,97.04431315
7/20/2003,136526,91994,33523,262043,96.76624815
7/21/2003,136145,91629,33446,261220,96.46233383
7/22/2003,136417,91888,33408,261713,96.644387
7/23/2003,136526,92390,33630,262546,96.95199409
7/24/2003,136435,92482,33504,262421,96.90583456
7/25/2003,136454,92573,33369,262396,96.89660266
7/26/2003,136290,92512,33427,262229,96.83493353
7/27/2003,136054,92360,33432,261846,96.69350074
7/28/2003,135873,92131,33437,261441,96.54394387
7/29/2003,135584,91888,33446,260918,96.35081241
7/30/2003,135185,91584,33446,260215,96.09121123
7/31/2003,134877,91264,33456,259597,95.86299852
8/1/2003,134588,90929,33360,258877,95.59711965
8/2/2003,134967,91036,33504,259507,95.82976366
8/3/2003,135167,91400,33548,260115,96.0542836
8/4/2003,135511,91477,34086,261074,96.4084195
8/5/2003,136345,92116,34433,262894,97.08050222
8/6/2003,137127,92786,34739,264652,97.72968981
8/7/2003,137674,93394,34798,265866,98.17799114
8/8/2003,138186,93699,34645,266530,98.42319055
8/9/2003,138076,94170,34443,266689,98.48190547
8/10/2003,138498,94428,34527,267453,98.7640325
8/11/2003,138866,94656,34818,268340,99.0915805
8/12/2003,139969,95220,34956,270145,99.75812408
8/13/2003,140987,95786,34966,271739,100.3467504
8/14/2003,141042,95996,34858,271896,100.4047267
8/15/2003,140727,95851,34818,271396,100.2200886
8/16/2003,140301,95754,34586,270641,99.94128508
8/17/2003,140282,95738,34404,270424,99.86115214
8/18/2003,140282,95851,34219,270352,99.83456425
8/19/2003,140227,95883,34023,270133,99.75369276
8/20/2003,140061,95803,33920,269784,99.62481536
8/21/2003,139969,95722,33823,269514,99.52511078
8/22/2003,139822,95584,33688,269094,99.37001477
8/23/2003,139656,95387,33543,268586,99.18242245
8/24/2003,139473,95204,33432,268109,99.0062777
8/25/2003,139418,94992,33461,267871,98.91838996
8/26/2003,139179,94763,33365,267307,98.71011817
8/27/2003,138848,94367,33201,266416,98.38109306
8/28/2003,138627,93911,33009,265547,98.06019202
8/29/2003,138333,93272,32815,264420,97.64401773
8/30/2003,138186,92846,32634,263666,97.36558346
8/31/2003,137985,92436,32477,262898,97.08197932
9/1/2003,137729,92131,32311,262171,96.81351551
9/2/2003,138664,92664,32514,263842,97.43057607
9/3/2003,140449,94885,33499,268833,99.27363368
9/4/2003,142323,95835,34184,272342,100.5694239
9/5/2003,142845,98056,34675,275576,101.7636632
9/6/2003,142267,98571,34700,275538,101.7496307
9/7/2003,141783,98523,34552,274858,101.4985229
9/8/2003,141486,98249,34350,274085,101.2130724
9/9/2003,140987,97846,34116,272949,100.7935746
9/10/2003,140597,97315,33886,271798,100.3685377
9/11/2003,140319,96896,33630,270845,100.0166174
9/12/2003,140061,96671,33336,270068,99.72968981
9/13/2003,139951,96543,33038,269532,99.53175775
9/14/2003,139767,96495,32752,269014,99.34047267
9/15/2003,139601,96447,32514,268562,99.17355982
9/16/2003,139712,96768,32643,269123,99.38072378
9/17/2003,139785,96623,32800,269208,99.41211226
9/18/2003,139712,96382,32886,268980,99.32791728
9/19/2003,139658,96124,33022,268804,99.26292467
9/20/2003,139804,96028,32991,268823,99.26994092
9/21/2003,139712,96028,32805,268545,99.16728213
9/22/2003,139601,96044,32552,268197,99.038774
9/23/2003,139804,96366,32420,268590,99.18389956
9/24/2003,141079,97782,33620,272481,100.6207533
9/25/2003,141061,97862,33669,272592,100.661743
9/26/2003,140950,97798,33606,272354,100.5738552
9/27/2003,140987,97637,33760,272384,100.5849335
9/28/2003,141635,97605,34340,273580,101.0265879
9/29/2003,142249,98088,35229,275566,101.7599705
9/30/2003,141969,98104,35080,275153,101.6074594
10/1/2003,141727,97637,35041,274405,101.3312408
10/2/2003,141431,97718,35001,274150,101.2370753
10/3/2003,141338,97395,34936,273669,101.0594535
10/4/2003,141246,97090,34936,273272,100.9128508
10/5/2003,141449,97251,35115,273815,101.1133678
10/6/2003,141338,97251,34931,273520,101.0044313
10/7/2003,141190,96784,34798,272772,100.7282127
10/8/2003,140894,96880,34739,272513,100.6325702
10/9/2003,140764,97186,34680,272630,100.6757755
10/10/2003,140634,97186,34472,272292,100.5509601
10/11/2003,140542,97106,34243,271891,100.4028804
10/12/2003,140431,97009,33993,271433,100.2337518
10/13/2003,140375,96945,33746,271066,100.0982275
10/14/2003,140301,96864,33485,270650,99.94460857
10/15/2003,140468,97009,33341,270818,100.006647
10/16/2003,140690,97540,33331,271561,100.2810192
10/17/2003,140672,97557,33173,271402,100.2223043
10/18/2003,140616,97476,32957,271049,100.0919498
10/19/2003,140560,97412,32723,270695,99.961226
10/20/2003,140597,97444,32529,270570,99.91506647
10/21/2003,140560,97122,32306,269988,99.70014771
10/22/2003,140523,97057,32075,269655,99.57717873
10/23/2003,140505,97009,31832,269346,99.46307238
10/24/2003,140468,97122,31592,269182,99.40251108
10/25/2003,140449,96913,31331,268693,99.22193501
10/26/2003,140412,96784,31058,268254,99.05982275
10/27/2003,140764,96864,30923,268551,99.16949778
10/28/2003,143013,98313,33538,274864,101.5007386
10/29/2003,143313,99086,34448,276847,102.2330133
10/30/2003,144211,101194,35409,280814,103.6979321
10/31/2003,142864,100888,35289,279041,103.0432053
11/1/2003,142286,100115,35229,277630,102.5221566
11/2/2003,141876,99424,35194,276494,102.1026588
11/3/2003,141653,98941,35174,275768,101.8345643
11/4/2003,141486,98539,35140,275165,101.6118907
11/5/2003,141319,98249,35125,274693,101.4375923
11/6/2003,141227,98168,35174,274569,101.3918021
11/7/2003,140931,97991,35150,274072,101.2082718
11/8/2003,140746,97750,35130,273626,101.0435746
11/9/2003,140913,97492,34917,273322,100.9313146
11/10/2003,140950,97235,34724,272909,100.7788035
11/11/2003,140838,97315,34532,272685,100.6960857
11/12/2003,140820,97251,34360,272431,100.6022895
11/13/2003,140672,97315,34155,272142,100.4955687
11/14/2003,140672,97412,33944,272028,100.4534712
11/15/2003,140579,97347,33717,271643,100.3112999
11/16/2003,140560,97347,33485,271392,100.2186115
11/17/2003,140505,97299,33249,271053,100.0934269
11/18/2003,140449,97267,33005,270721,99.97082718
11/19/2003,140505,97138,32805,270448,99.87001477
11/20/2003,142733,98748,33857,275338,101.6757755
11/21/2003,142939,100614,34448,278001,102.6591581
11/22/2003,142435,100132,34562,277129,102.3371492
11/23/2003,142043,99376,34572,275991,101.9169129
11/24/2003,141764,98716,34517,274997,101.5498523
11/25/2003,141727,98571,34453,274751,101.4590103
11/26/2003,141598,98217,34389,274204,101.2570162
11/27/2003,141486,98104,34238,273828,101.1181684
11/28/2003,141375,98072,34096,273543,101.0129247
11/29/2003,142062,98265,34586,274913,101.5188331
11/30/2003,142062,98394,34724,275180,101.6174298
12/1/2003,141894,98088,34729,274711,101.4442393
12/2/2003,141486,98056,35006,274548,101.3840473
12/3/2003,141245,98007,35115,274367,101.3172083
12/4/2003,140913,97959,35130,274002,101.1824225
12/5/2003,140801,97911,35135,273847,101.1251846
12/6/2003,140672,97750,35135,273557,101.0180945
12/7/2003,140579,97605,35135,273319,100.9302068
12/8/2003,140486,97508,35130,273124,100.8581979
12/9/2003,140356,97363,35150,272869,100.7640325
12/10/2003,140264,97235,35150,272649,100.6827917
12/11/2003,140282,97267,35140,272689,100.6975628
12/12/2003,141839,99392,35428,276659,102.1635894
12/13/2003,141727,99650,35244,276621,102.1495569
12/14/2003,141412,99215,35184,275811,101.8504431
12/15/2003,141394,98893,35174,275461,101.7211965
12/16/2003,141134,98716,35140,274990,101.5472674
12/17/2003,141079,98233,35145,274457,101.3504431
12/18/2003,141653,98394,35189,275236,101.6381093
12/19/2003,141468,98490,35155,275113,101.5926883
12/20/2003,141208,98281,35135,274624,101.4121123
12/21/2003,140894,98088,35120,274102,101.2193501
12/22/2003,140727,97846,35115,273688,101.0664697
12/23/2003,140616,97734,35120,273470,100.9859675
12/24/2003,140894,97862,35150,273906,101.1469719
12/25/2003,143480,100598,35538,279616,103.2555391
12/26/2003,142789,101162,35284,279235,103.1148449
12/27/2003,142304,100502,35204,278010,102.6624815
12/28/2003,141931,99810,35179,276920,102.2599705
12/29/2003,141709,99231,35174,276114,101.9623338
12/30/2003,141542,98683,35011,275236,101.6381093
12/31/2003,141412,98555,34853,274820,101.4844904
1/1/2004,141098,98297,34749,274144,101.2348597
1/2/2004,140690,98120,34926,273736,101.084195
1/3/2004,140375,97975,35080,273430,100.9711965
1/4/2004,140393,98136,35155,273684,101.0649926
1/5/2004,140560,98474,35229,274263,101.2788035
1/6/2004,140690,98555,35189,274434,101.3419498
1/7/2004,140579,98458,35155,274192,101.2525849
1/8/2004,140375,98265,35140,273780,101.1004431
1/9/2004,139840,98104,35140,273084,100.8434269
1/10/2004,139381,97782,35100,272263,100.5402511
1/11/2004,138793,97540,35085,271418,100.2282127
1/12/2004,138314,97476,35120,270910,100.0406204
1/13/2004,137894,97508,35135,270537,99.90288035
1/14/2004,137328,97492,35061,269881,99.66063516
1/15/2004,136781,97363,35056,269200,99.40915805
1/16/2004,136073,96977,35051,268101,99.00332349
1/17/2004,135385,96607,35051,267043,98.61262925
1/18/2004,134859,96447,35056,266362,98.36115214
1/19/2004,134498,96334,35061,265893,98.1879616
1/20/2004,134318,96189,35051,265558,98.06425406
1/21/2004,134049,96092,35051,265192,97.92909897
1/22/2004,133851,96028,35051,264930,97.8323486
1/23/2004,133599,95915,35031,264545,97.69017725
1/24/2004,133186,95867,35031,264084,97.51994092
1/25/2004,132880,95738,35031,263649,97.35930576
1/26/2004,132558,95615,35036,263209,97.19682422
1/27/2004,132272,95493,35036,262801,97.04615953
1/28/2004,132004,95417,35051,262472,96.92466765
1/29/2004,131719,95296,35041,262056,96.77104874
1/30/2004,131487,95220,35036,261743,96.65546529
1/31/2004,131007,95007,35036,261050,96.39955687
2/1/2004,130652,94870,35036,260558,96.21787297
2/2/2004,130387,94671,35046,260104,96.05022157
2/3/2004,129908,94489,35041,259438,95.8042836
2/4/2004,129625,94337,35056,259018,95.64918759
2/5/2004,129113,94155,35016,258284,95.37813885
2/6/2004,128813,94018,35031,257862,95.22230428
2/7/2004,128620,93927,35056,257603,95.12666174
2/8/2004,128269,93911,35046,257226,94.98744461
2/9/2004,127917,93820,35041,256778,94.82200886
2/10/2004,127548,93699,35041,256288,94.64106352
2/11/2004,127198,93592,35041,255831,94.47230428
2/12/2004,126813,93501,35036,255350,94.29468242
2/13/2004,126325,93379,35041,254745,94.07127031
2/14/2004,125940,93135,35036,254111,93.83714919
2/15/2004,125522,92862,35026,253410,93.57828656
2/16/2004,125122,92618,35011,252751,93.33493353
2/17/2004,124690,92299,34991,251980,93.05022157
2/18/2004,124326,92025,34996,251347,92.81646972
2/19/2004,123911,91751,34996,250658,92.5620384
2/20/2004,123531,91431,35001,249963,92.30539143
2/21/2004,123101,91066,35001,249168,92.01181684
2/22/2004,122756,90716,34996,248468,91.75332349
2/23/2004,122498,90580,34991,248069,91.60598227
2/24/2004,121985,90275,34986,247246,91.30206795
2/25/2004,121608,89986,35001,246595,91.06166913
2/26/2004,121197,89743,35006,245946,90.82200886
2/27/2004,120821,89560,35006,245387,90.61558346
2/28/2004,120395,89332,35006,244733,90.37407681
2/29/2004,120004,89059,35001,244064,90.12703102
3/1/2004,119614,88998,35001,243613,89.96048744
3/2/2004,119257,88861,35031,243149,89.78914328
3/3/2004,119257,89165,35066,243488,89.91432792
3/4/2004,119614,90306,35046,244966,90.46011817
3/5/2004,120310,91736,34808,246854,91.15731167
3/6/2004,121882,94170,34562,250614,92.54579025
3/7/2004,125036,98249,34680,257965,95.26033973
3/8/2004,127128,99585,34675,261388,96.52437223
3/9/2004,128532,99456,34482,262470,96.9239291
3/10/2004,129447,99070,34209,262726,97.01846381
3/11/2004,130387,98619,33915,262921,97.09047267
3/12/2004,131273,98233,33606,263112,97.16100443
3/13/2004,131915,98120,33307,263342,97.24593796
3/14/2004,132486,97814,32976,263276,97.22156573
3/15/2004,132540,97718,32634,262892,97.07976366
3/16/2004,132773,97557,32292,262622,96.98005908
3/17/2004,133132,97476,32227,262835,97.05871492
3/18/2004,133258,97363,32170,262791,97.04246677
3/19/2004,133348,97251,32118,262717,97.01514032
3/20/2004,133401,97138,32052,262591,96.96861152
3/21/2004,133653,97122,32028,262803,97.04689808
3/22/2004,133905,97315,31991,263211,97.19756278
3/23/2004,133959,97235,31906,263100,97.15657312
3/24/2004,134049,97186,31822,263057,97.14069424
3/25/2004,133959,97202,31728,262889,97.07865583
3/26/2004,133995,97315,31677,262987,97.1148449
3/27/2004,134300,97589,31761,263650,97.35967504
3/28/2004,135222,98136,32056,265414,98.01107829
3/29/2004,136073,98410,32278,266761,98.50849335
3/30/2004,136690,98410,32401,267501,98.78175775
3/31/2004,137163,98265,32524,267952,98.94830133
4/1/2004,137564,98104,32671,268339,99.09121123
4/2/2004,138443,98088,33110,269641,99.57200886
4/3/2004,139087,98088,33408,270583,99.91986706
4/4/2004,139547,97975,33577,271099,100.1104136
4/5/2004,139932,97798,33717,271447,100.2389217
4/6/2004,140301,97653,33794,271748,100.3500739
4/7/2004,140709,97540,33939,272188,100.5125554
4/8/2004,140950,97460,33949,272359,100.5757016
4/9/2004,140801,97347,33949,272097,100.4789513
4/10/2004,140634,97267,33964,271865,100.3932792
4/11/2004,140505,97170,33983,271658,100.316839
4/12/2004,140393,97041,34033,271467,100.2463072
4/13/2004,140449,97057,34091,271597,100.2943131
4/14/2004,140653,97492,34355,272500,100.6277696
4/15/2004,140913,97701,34277,272891,100.7721566
4/16/2004,141005,97718,34126,272849,100.756647
4/17/2004,140894,97653,34086,272633,100.6768833
4/18/2004,140838,97589,34052,272479,100.6200148
4/19/2004,140894,97573,34008,272475,100.6185377
4/20/2004,140913,97573,33988,272474,100.6181684
4/21/2004,140857,97508,33935,272300,100.5539143
4/22/2004,140616,97412,33823,271851,100.3881093
4/23/2004,140634,97267,33727,271628,100.3057607
4/24/2004,140597,97299,33803,271699,100.3319793
4/25/2004,140486,97251,33818,271555,100.2788035
4/26/2004,140634,97251,33954,271839,100.383678
4/27/2004,140950,97621,34394,272965,100.799483
4/28/2004,141153,97685,34365,273203,100.8873708
4/29/2004,141282,97669,34209,273160,100.8714919
4/30/2004,141282,97605,34023,272910,100.7791728
5/1/2004,140931,97524,33979,272434,100.6033973
5/2/2004,140727,97428,33949,272104,100.4815362
5/3/2004,140820,97685,33983,272488,100.6233383
5/4/2004,140820,97959,34033,272812,100.7429838
5/5/2004,140764,97862,34028,272654,100.6846381
5/6/2004,140764,97846,34023,272633,100.6768833
5/7/2004,140690,97798,34165,272653,100.6842688
5/8/2004,140634,97685,34160,272479,100.6200148
5/9/2004,140523,97540,34160,272223,100.5254801
5/10/2004,140375,97444,34145,271964,100.4298375
5/11/2004,140301,97524,34199,272024,100.4519941
5/12/2004,140264,97460,34228,271952,100.4254062
5/13/2004,140319,97524,34184,272027,100.4531019
5/14/2004,140634,97444,34224,272302,100.5546529
5/15/2004,140616,97347,34238,272201,100.517356
5/16/2004,140653,97315,34243,272211,100.5210487
5/17/2004,140542,97267,34209,272018,100.4497784
5/18/2004,140338,96880,34194,271412,100.225997
5/19/2004,140338,96687,34219,271244,100.1639586
5/20/2004,140282,96511,34189,270982,100.0672083
5/21/2004,140116,96479,34199,270794,99.99778434
5/22/2004,139988,96431,34228,270647,99.94350074
5/23/2004,139859,96398,34233,270490,99.88552437
5/24/2004,139730,96302,34277,270309,99.81868538
5/25/2004,139767,96302,34389,270458,99.87370753
5/26/2004,139840,96189,34404,270433,99.86447563
5/27/2004,140301,96157,34665,271123,100.1192762
5/28/2004,140616,97331,34695,272642,100.6802068
5/29/2004,140672,97444,34749,272865,100.7625554
5/30/2004,140616,97331,34675,272622,100.6728213
5/31/2004,140505,97154,34625,272284,100.5480059
6/1/2004,140542,97041,34586,272169,100.5055391
6/2/2004,140672,97057,34675,272404,100.5923191
6/3/2004,140653,97057,34808,272518,100.6344165
6/4/2004,140579,97138,34744,272461,100.6133678
6/5/2004,140356,97073,34670,272099,100.4796898
6/6/2004,140301,97009,34645,271955,100.426514
6/7/2004,140282,96945,34562,271789,100.3652142
6/8/2004,140098,96671,34562,271331,100.1960857
6/9/2004,139969,96237,34532,270738,99.97710487
6/10/2004,139877,95948,34552,270377,99.84379616
6/11/2004,139822,95770,34562,270154,99.76144756
6/12/2004,139693,95554,34581,269828,99.64106352
6/13/2004,139528,95311,34620,269459,99.50480059
6/14/2004,139289,95113,34630,269032,99.34711965
6/15/2004,139069,94931,34635,268635,99.20051699
6/16/2004,138848,94702,34502,268052,98.98522895
6/17/2004,138553,94489,34350,267392,98.74150665
6/18/2004,138461,94231,34306,266998,98.59601182
6/19/2004,138223,93866,34316,266405,98.37703102
6/20/2004,137948,93547,34263,265758,98.13810931
6/21/2004,137637,93242,34199,265078,97.88700148
6/22/2004,137273,92922,34219,264414,97.64180207
6/23/2004,137017,92634,34101,263752,97.39734121
6/24/2004,136672,92314,33959,262945,97.0993353
6/25/2004,136236,91964,33872,262072,96.77695716
6/26/2004,135910,91645,33770,261325,96.50110783
6/27/2004,135602,91324,33703,260629,96.24409158
6/28/2004,135149,91051,33591,259791,95.93463811
6/29/2004,134714,90701,33475,258890,95.60192024
6/30/2004,134264,90168,33350,257782,95.19276219
7/1/2004,133797,89743,33221,256761,94.81573117
7/2/2004,133455,89256,33077,255788,94.45642541
7/3/2004,133042,88541,32967,254550,93.99926145
7/4/2004,132486,87811,32848,253145,93.48042836
7/5/2004,131951,87103,32723,251777,92.97525849
7/6/2004,131630,86597,32624,250851,92.63330871
7/7/2004,131113,86019,32514,249646,92.18833087
7/8/2004,130848,85658,32430,248936,91.92614476
7/9/2004,130528,85268,32321,248117,91.62370753
7/10/2004,130138,84646,32175,246959,91.19608567
7/11/2004,129819,84097,32052,245968,90.83013294
7/12/2004,129483,83678,31906,245067,90.49741507
7/13/2004,129165,83330,31804,244299,90.21381093
7/14/2004,128813,83013,31677,243503,89.91986706
7/15/2004,128673,82897,31686,243256,89.82865583
7/16/2004,128444,82782,31667,242893,89.69460857
7/17/2004,128251,82565,31583,242399,89.51218612
7/18/2004,128005,82333,31513,241851,89.30982275
7/19/2004,127794,82102,31466,241362,89.12924668
7/20/2004,127548,81987,31405,240940,88.97341211
7/21/2004,127320,81669,31275,240264,88.72378139
7/22/2004,127059,81163,31076,239298,88.36706056
7/23/2004,126743,80696,30937,238376,88.02658789
7/24/2004,126796,80640,33048,240484,88.80502216
7/25/2004,126883,80627,33577,241087,89.02769572
7/26/2004,126831,80557,33823,241211,89.07348597
7/27/2004,126866,80571,34047,241484,89.17429838
7/28/2004,128602,82767,34537,245906,90.80723781
7/29/2004,129678,84718,34897,249293,92.05797637
7/30/2004,130387,85846,34961,251194,92.75997046
7/31/2004,130883,86641,34887,252411,93.20937962
8/1/2004,131434,87349,34808,253591,93.64512555
8/2/2004,131915,88042,34665,254622,94.02584934
8/3/2004,132361,88571,34502,255434,94.32570162
8/4/2004,132594,88952,34326,255872,94.48744461
8/5/2004,132755,89180,34121,256056,94.55539143
8/6/2004,132916,89484,34042,256442,94.69793205
8/7/2004,132791,89682,33944,256417,94.68870015
8/8/2004,133024,89682,33746,256452,94.70162482
8/9/2004,133168,89606,33543,256317,94.65177253
8/10/2004,133204,89423,33317,255944,94.5140325
8/11/2004,132916,89271,33081,255268,94.26440177
8/12/2004,132701,89165,33125,254991,94.16211226
8/13/2004,134606,89591,34326,258523,95.46639586
8/14/2004,136981,90488,35254,262723,97.01735598
8/15/2004,138186,91066,35194,264446,97.65361891
8/16/2004,140950,91705,35165,267820,98.89955687
8/17/2004,141876,92634,35174,269684,99.58788774
8/18/2004,141746,93379,35110,270235,99.79135894
8/19/2004,141245,93896,35051,270192,99.77548006
8/20/2004,140820,94383,35046,270249,99.7965288
8/21/2004,140727,94641,34931,270299,99.81499261
8/22/2004,140913,95387,35031,271331,100.1960857
8/23/2004,140801,95600,34946,271347,100.2019941
8/24/2004,140690,95786,34808,271284,100.1787297
8/25/2004,140505,95691,34685,270881,100.0299114
8/26/2004,140338,95584,34522,270444,99.86853767
8/27/2004,140043,95539,34360,269942,99.683161
8/28/2004,140043,95493,34189,269725,99.60302806
8/29/2004,140080,95356,34180,269616,99.56277696
8/30/2004,140043,95128,34033,269204,99.41063516
8/31/2004,139785,95220,34350,269355,99.46639586
9/1/2004,139400,95311,34419,269130,99.38330871
9/2/2004,139087,95311,34277,268675,99.21528804
9/3/2004,138921,95296,34130,268347,99.09416544
9/4/2004,138829,95235,33896,267960,98.95125554
9/5/2004,138756,95220,33717,267693,98.85265879
9/6/2004,138627,95189,33533,267349,98.72562777
9/7/2004,138517,95144,33331,266992,98.59379616
9/8/2004,138314,95144,33144,266602,98.44977843
9/9/2004,138682,95630,33197,267509,98.78471196
9/10/2004,139069,96044,33857,268970,99.32422452
9/11/2004,139363,95819,34028,269210,99.41285081
9/12/2004,139565,95569,33959,269093,99.36964549
9/13/2004,139693,95508,33833,269034,99.3478582
9/14/2004,139767,95402,33693,268862,99.28434269
9/15/2004,139693,95356,33499,268548,99.16838996
9/16/2004,139345,95326,33432,268103,99.00406204
9/17/2004,139124,95296,33374,267794,98.88995569
9/18/2004,143107,98200,34404,275711,101.8135155
9/19/2004,145152,104145,35409,284706,105.1351551
9/20/2004,143219,102530,35204,280953,103.7492614
9/21/2004,142323,100888,35150,278361,102.7920975
9/22/2004,141857,99874,34981,276712,102.183161
9/23/2004,141542,99086,34892,275520,101.7429838
9/24/2004,140913,98152,34719,273784,101.1019202
9/25/2004,140468,97186,34502,272156,100.5007386
9/26/2004,140431,96559,34277,271267,100.172452
9/27/2004,140356,95980,34033,270369,99.84084195
9/28/2004,140135,95931,33852,269918,99.67429838
9/29/2004,141153,96800,34606,272559,100.6495569
9/30/2004,141171,96431,34778,272380,100.5834564
10/1/2004,141227,96109,34769,272105,100.4819055
10/2/2004,141079,95948,34655,271682,100.3257016
10/3/2004,140987,95899,34527,271413,100.2263663
10/4/2004,140857,95770,34374,271001,100.0742245
10/5/2004,140709,95630,34547,270886,100.0317578
10/6/2004,140616,95554,34670,270840,100.014771
10/7/2004,140449,95448,34833,270730,99.97415066
10/8/2004,140024,95432,34966,270422,99.86041359
10/9/2004,139785,95706,34818,270309,99.81868538
10/10/2004,139601,96028,34562,270191,99.77511078
10/11/2004,139510,96253,34306,270069,99.73005908
10/12/2004,139656,96382,34394,270432,99.86410635
10/13/2004,139748,96414,34468,270630,99.93722304
10/14/2004,139822,96479,34482,270783,99.9937223
10/15/2004,139712,96543,34370,270625,99.93537666
10/16/2004,139418,96816,34086,270320,99.82274742
10/17/2004,139069,96832,33842,269743,99.60967504
10/18/2004,138737,96880,33591,269208,99.41211226
10/19/2004,138903,96961,33703,269567,99.54468242
10/20/2004,139308,97267,33974,270549,99.90731167
10/21/2004,139381,97154,34111,270646,99.94313146
10/22/2004,139363,97202,34003,270568,99.91432792
10/23/2004,139179,97235,33751,270165,99.7655096
10/24/2004,138958,97251,33489,269698,99.59305761
10/25/2004,138756,97235,33245,269236,99.42245199
10/26/2004,138958,97202,33341,269501,99.52031019
10/27/2004,139161,97170,33432,269763,99.61706056
10/28/2004,139400,97138,33485,270023,99.71307238
10/29/2004,139271,97073,33360,269704,99.59527326
10/30/2004,138995,97025,33057,269077,99.36373708
10/31/2004,138701,96977,32752,268430,99.12481536
11/1/2004,138443,96961,32481,267885,98.92355982
11/2/2004,138517,96735,32548,267800,98.89217134
11/3/2004,138645,96559,32634,267838,98.90620384
11/4/2004,138682,96398,32643,267723,98.86373708
11/5/2004,138609,96318,32567,267494,98.77917282
11/6/2004,138461,96286,32325,267072,98.62333826
11/7/2004,138205,96237,32052,266494,98.4098966
11/8/2004,137930,96092,31790,265812,98.15805022
11/9/2004,137583,95819,31818,265220,97.9394387
11/10/2004,137218,95417,31888,264523,97.68205318
11/11/2004,136890,95615,31962,264467,97.66137371
11/12/2004,136617,95964,32014,264595,97.70864106
11/13/2004,136218,96205,31846,264269,97.58825702
11/14/2004,135892,96382,31527,263801,97.41543575
11/15/2004,135493,96495,31266,263254,97.21344165
11/16/2004,135149,96511,30966,262626,96.98153619
11/17/2004,134841,96575,30818,262234,96.83677991
11/18/2004,134444,96591,30625,261660,96.62481536
11/19/2004,134102,96623,30406,261131,96.42946824
11/20/2004,133743,96655,30191,260589,96.22932053
11/21/2004,133437,96671,29950,260058,96.03323486
11/22/2004,133114,96703,29706,259523,95.83567208
11/23/2004,132755,96703,29455,258913,95.61041359
11/24/2004,132415,96687,29204,258306,95.38626292
11/25/2004,132200,96752,29096,258048,95.29098966
11/26/2004,132433,97251,29114,258798,95.56794682
11/27/2004,132486,97508,28981,258975,95.63330871
11/28/2004,132612,97685,28861,259158,95.70088626
11/29/2004,134516,99424,30378,264318,97.60635155
11/30/2004,135964,99521,30850,266335,98.35118168
12/1/2004,137200,99392,31224,267816,98.89807976
12/2/2004,139583,100276,32491,272350,100.5723781
12/3/2004,140820,99987,32972,273779,101.1000739
12/4/2004,141319,99666,33307,274292,101.2895126
12/5/2004,141375,99311,33557,274243,101.271418
12/6/2004,141357,98490,33770,273617,101.0402511
12/7/2004,141282,98072,33983,273337,100.9368538
12/8/2004,141338,98426,34316,274080,101.211226
12/9/2004,141301,98458,34497,274256,101.2762186
12/10/2004,141301,98345,34527,274173,101.2455687
12/11/2004,142043,99295,34675,276013,101.9250369
12/12/2004,142174,99954,34882,277010,102.2932053
12/13/2004,141969,99842,34907,276718,102.1853767
12/14/2004,141801,99601,34853,276255,102.0144018
12/15/2004,141616,99022,34690,275328,101.6720827
12/16/2004,141394,98458,34507,274359,101.3142541
12/17/2004,141245,98040,34301,273586,101.0288035
12/18/2004,141208,97846,34145,273199,100.8858936
12/19/2004,141079,97766,33920,272765,100.7256278
12/20/2004,140987,97524,33693,272204,100.5184638
12/21/2004,140894,97428,33417,271739,100.3467504
12/22/2004,140709,97395,33163,271267,100.172452
12/23/2004,140542,97170,32924,270636,99.9394387
12/24/2004,141876,98394,33408,273678,101.062777
12/25/2004,141727,99102,33432,274261,101.278065
12/26/2004,141431,98989,33297,273717,101.0771787
12/27/2004,141227,98716,33153,273096,100.8478582
12/28/2004,140987,98458,32934,272379,100.5830871
12/29/2004,141079,98249,32728,272056,100.4638109
12/30/2004,141098,98152,32533,271783,100.3629985
12/31/2004,141042,97798,32306,271146,100.1277696
1/1/2005,141005,97830,32155,270990,100.0701625
1/2/2005,140709,97701,32302,270712,99.96750369
1/3/2005,140560,97621,32463,270644,99.94239291
1/4/2005,140746,97878,32728,271352,100.2038405
1/5/2005,140820,98023,32995,271838,100.3833087
1/6/2005,140764,98056,33125,271945,100.4228213
1/7/2005,140764,98104,33273,272141,100.4951994
1/8/2005,140653,98120,33470,272243,100.5328656
1/9/2005,140727,98120,33644,272491,100.6244461
1/10/2005,140634,97959,33770,272363,100.5771787
1/11/2005,140505,97814,33905,272224,100.5258493
1/12/2005,140542,97830,34062,272434,100.6033973
1/13/2005,140542,98120,34243,272905,100.7773264
1/14/2005,142976,100325,35184,278485,102.8378877
1/15/2005,143536,102675,35458,281669,104.0136632
1/16/2005,142547,101902,35309,279758,103.3079764
1/17/2005,142043,100792,35259,278094,102.6935007
1/18/2005,141764,99938,35204,276906,102.2548006
1/19/2005,141486,99134,34981,275601,101.7728951
1/20/2005,141412,98571,34759,274742,101.4556869
1/21/2005,141190,98394,34921,274505,101.3681684
1/22/2005,140894,98023,35041,273958,101.1661743
1/23/2005,140820,97862,35100,273782,101.1011817
1/24/2005,140727,97766,35095,273588,101.0295421
1/25/2005,140672,97637,35095,273404,100.9615953
1/26/2005,140616,97589,35090,273295,100.9213442
1/27/2005,140153,97540,35085,272778,100.7304284
1/28/2005,139583,97428,35061,272072,100.4697194
1/29/2005,139161,97235,35036,271432,100.2333826
1/30/2005,139013,96929,35016,270958,100.0583456
1/31/2005,138829,96735,35051,270615,99.9316839
2/1/2005,138590,96543,35051,270184,99.77252585
2/2/2005,138369,96350,35046,269765,99.61779911
2/3/2005,138058,96221,35046,269325,99.45531758
2/4/2005,137839,96141,35046,269026,99.34490399
2/5/2005,137583,96076,35046,268705,99.22636632
2/6/2005,137291,95899,35041,268231,99.05132939
2/7/2005,137036,95786,35036,267858,98.91358936
2/8/2005,136781,95615,35046,267442,98.75997046
2/9/2005,136544,95432,35036,267012,98.60118168
2/10/2005,136199,95615,35051,266865,98.54689808
2/11/2005,135873,96173,35100,267146,98.6506647
2/12/2005,135584,96092,35061,266737,98.49963072
2/13/2005,135475,96237,35056,266768,98.51107829
2/14/2005,135348,96334,35051,266733,98.49815362
2/15/2005,135439,96719,35070,267228,98.68094535
2/16/2005,135873,97315,35120,268308,99.07976366
2/17/2005,136363,98023,35130,269516,99.52584934
2/18/2005,136763,98345,35125,270233,99.79062038
2/19/2005,136726,97830,35085,269641,99.57200886
2/20/2005,136599,97653,35075,269327,99.45605613
2/21/2005,136436,97412,35085,268933,99.3105613
2/22/2005,136417,97106,35085,268608,99.19054653
2/23/2005,136381,97186,35080,268647,99.2049483
2/24/2005,136309,96945,35051,268305,99.07865583
2/25/2005,136127,96832,35051,268010,98.96971935
2/26/2005,136000,96752,35051,267803,98.89327917
2/27/2005,136000,96687,35046,267733,98.86742984
2/28/2005,135982,96527,35046,267555,98.80169867
3/1/2005,135801,96398,35061,267260,98.69276219
3/2/2005,135475,96350,35046,266871,98.54911374
3/3/2005,135185,96237,35051,266473,98.4021418
3/4/2005,134895,96173,35046,266114,98.26957164
3/5/2005,134534,96060,35046,265640,98.09453471
3/6/2005,134210,95931,35046,265187,97.92725258
3/7/2005,133923,95786,35051,264760,97.76957164
3/8/2005,133599,95931,35046,264576,97.70162482
3/9/2005,133473,96125,35061,264659,97.73227474
3/10/2005,133294,96044,35051,264389,97.63257016
3/11/2005,133024,96092,35046,264162,97.54874446
3/12/2005,132755,96044,35051,263850,97.43353028
3/13/2005,132486,96044,35051,263581,97.33419498
3/14/2005,132111,96028,35046,263185,97.1879616
3/15/2005,131862,96269,35041,263172,97.183161
3/16/2005,131648,96125,35041,262814,97.05096012
3/17/2005,131434,96044,35031,262509,96.93833087
3/18/2005,131184,95931,35031,262146,96.8042836
3/19/2005,130865,95803,35026,261694,96.63737075
3/20/2005,130599,95803,35021,261423,96.5372969
3/21/2005,130351,95835,35036,261222,96.46307238
3/22/2005,130049,95770,35016,260835,96.32016248
3/23/2005,129837,95819,35016,260672,96.25997046
3/24/2005,129731,95931,35021,260683,96.2640325
3/25/2005,129483,95931,35031,260445,96.17614476
3/26/2005,129501,95980,35031,260512,96.20088626
3/27/2005,129589,96108,35036,260733,96.28249631
3/28/2005,129908,96478,35041,261427,96.538774
3/29/2005,133653,99569,35414,268636,99.20088626
3/30/2005,138021,101774,35384,275179,101.6170606
3/31/2005,140283,101597,35294,277174,102.3537666
4/1/2005,141598,101275,35269,278142,102.711226
4/2/2005,142230,101033,35294,278557,102.8644756
4/3/2005,147082,105085,36421,288588,106.5686854
4/4/2005,144626,106654,35498,286778,105.9002954
4/5/2005,143163,105016,35299,283478,104.6816839
4/6/2005,142435,101548,35234,279217,103.1081979
4/7/2005,142080,100470,35229,277779,102.5771787
4/8/2005,141894,99890,35264,277048,102.3072378
4/9/2005,141802,99392,35234,276428,102.0782866
4/10/2005,141617,99006,35194,275817,101.8526588
4/11/2005,141431,98651,35170,275252,101.6440177
4/12/2005,141301,98313,35031,274645,101.4198671
4/13/2005,141227,98088,34927,274242,101.2710487
4/14/2005,140857,97911,35041,273809,101.1111521
4/15/2005,140616,97766,34882,273264,100.9098966
4/16/2005,140412,97605,34729,272746,100.7186115
4/17/2005,140282,97476,34557,272315,100.5594535
4/18/2005,140080,97395,34384,271859,100.3910635
4/19/2005,139914,97267,34199,271380,100.2141802
4/20/2005,139712,97186,33998,270896,100.0354505
4/21/2005,139675,97106,33813,270594,99.9239291
4/22/2005,139638,97073,33640,270351,99.83419498
4/23/2005,139455,97025,33625,270105,99.74335303
4/24/2005,139785,97315,33964,271064,100.0974889
4/25/2005,140412,97814,34675,272901,100.7758493
4/26/2005,140709,97911,34941,273561,101.0195716
4/27/2005,140820,97878,35115,273813,101.1126292
4/28/2005,141134,98104,35145,274383,101.3231167
4/29/2005,141134,98168,35061,274363,101.3157312
4/30/2005,140968,98136,35021,274125,101.2278434
5/1/2005,140838,98040,35036,273914,101.1499261
5/2/2005,140727,97991,34981,273699,101.0705318
5/3/2005,140653,97927,34936,273516,101.0029542
5/4/2005,140542,97830,34867,273239,100.9006647
5/5/2005,140468,97685,34705,272858,100.7599705
5/6/2005,140375,97573,34645,272593,100.6621123
5/7/2005,140282,97460,34591,272333,100.5661004
5/8/2005,140153,97347,34685,272185,100.5114476
5/9/2005,140061,97251,34769,272081,100.4730428
5/10/2005,139951,97170,34853,271974,100.4335303
5/11/2005,139767,96880,34917,271564,100.282127
5/12/2005,139510,96495,34788,270793,99.99741507
5/13/2005,139271,96173,34660,270104,99.74298375
5/14/2005,138977,95835,34502,269314,99.45125554
5/15/2005,138866,95569,34532,268967,99.32311669
5/16/2005,138682,95311,34562,268555,99.17097489
5/17/2005,138535,95144,34591,268270,99.06573117
5/18/2005,138186,94946,34601,267733,98.86742984
5/19/2005,138040,94747,34616,267403,98.74556869
5/20/2005,137875,94611,34601,267087,98.6288774
5/21/2005,137564,94322,34596,266482,98.40546529
5/22/2005,137218,94063,34586,265867,98.17836041
5/23/2005,136908,93851,34581,265340,97.98375185
5/24/2005,136599,93653,34562,264814,97.78951256
5/25/2005,136218,93410,34562,264190,97.55908419
5/26/2005,135928,93211,34557,263696,97.37666174
5/27/2005,135584,92998,34552,263134,97.16912851
5/28/2005,135258,92786,34562,262606,96.97415066
5/29/2005,134986,92512,34562,262060,96.77252585
5/30/2005,134768,92284,34596,261648,96.62038405
5/31/2005,134408,92040,34601,261049,96.39918759
6/1/2005,134192,91766,34355,260313,96.1274003
6/2/2005,133995,91492,34233,259720,95.9084195
6/3/2005,133797,91218,34219,259234,95.72895126
6/4/2005,133581,90884,34194,258659,95.51661743
6/5/2005,133366,90488,34160,258014,95.27843427
6/6/2005,133132,89986,34126,257244,94.99409158
6/7/2005,132952,89545,34184,256681,94.78618907
6/8/2005,132719,89211,34165,256095,94.56979321
6/9/2005,132486,88739,34135,255360,94.29837518
6/10/2005,132272,88298,34111,254681,94.04763663
6/11/2005,132004,87782,34067,253853,93.74187592
6/12/2005,131737,87320,34037,253094,93.46159527
6/13/2005,131487,86872,34018,252377,93.19682422
6/14/2005,131202,86626,33988,251816,92.98966027
6/15/2005,130741,86279,33939,250959,92.67319055
6/16/2005,130369,85976,33876,250221,92.4006647
6/17/2005,130014,85730,33881,249625,92.18057607
6/18/2005,129625,85514,33876,249015,91.95531758
6/19/2005,129201,85296,33833,248330,91.70236337
6/20/2005,128761,85007,33808,247576,91.4239291
6/21/2005,128286,84675,33765,246726,91.11004431
6/22/2005,127811,84212,33717,245740,90.74593796
6/23/2005,127302,83764,33659,244725,90.3711226
6/24/2005,126848,83215,33596,243659,89.97747415
6/25/2005,126307,82507,33533,242347,89.49298375
6/26/2005,125731,81856,33451,241038,89.00960118
6/27/2005,125279,81423,33408,240110,88.66691285
6/28/2005,124759,81062,33398,239219,88.33788774
6/29/2005,124291,80640,33403,238334,88.01107829
6/30/2005,124170,80571,33417,238158,87.94608567
7/1/2005,123893,80585,33499,237977,87.87924668
7/2/2005,123669,80488,33264,237421,87.6739291
7/3/2005,123548,80460,32948,236956,87.50221566
7/4/2005,123187,80432,32643,236262,87.24593796
7/5/2005,122895,80446,32335,235676,87.0295421
7/6/2005,122929,80543,32099,235571,86.99076809
7/7/2005,122670,80654,31851,235175,86.84453471
7/8/2005,122515,81149,31560,235224,86.86262925
7/9/2005,122515,81683,31391,235589,86.99741507
7/10/2005,122275,82088,31168,235531,86.97599705
7/11/2005,122104,82319,30896,235319,86.89771049
7/12/2005,121762,82405,30566,234733,86.68131462
7/13/2005,121368,82492,30223,234083,86.44128508
7/14/2005,121009,82521,29914,233444,86.20531758
7/15/2005,120565,82579,29522,232666,85.91802068
7/16/2005,120157,82492,29123,231772,85.58788774
7/17/2005,119699,82477,28725,230901,85.26624815
7/18/2005,119308,82477,28407,230192,85.00443131
7/19/2005,118867,82463,28167,229497,84.74778434
7/20/2005,118427,82434,27909,228770,84.47932053
7/21/2005,117938,82333,27580,227851,84.13995569
7/22/2005,117433,82175,27219,226827,83.76181684
7/23/2005,116964,81669,26885,225518,83.27843427
7/24/2005,116478,81308,26540,224326,82.83825702
7/25/2005,116261,81091,26194,223546,82.55022157
7/26/2005,116194,80599,25829,222622,82.20901034
7/27/2005,115725,80060,25462,221247,81.70125554
7/28/2005,115260,79562,25105,219927,81.21381093
7/29/2005,114762,78926,24735,218423,80.6584195
7/30/2005,114246,78001,24348,216595,79.98338257
7/31/2005,113865,77365,24083,215313,79.50997046
8/1/2005,113371,76398,23951,213720,78.92171344
8/2/2005,112909,75610,23947,212466,78.45864106
8/3/2005,112448,74865,23926,211239,78.00553914
8/4/2005,111890,74133,23837,209860,77.49630724
8/5/2005,111431,73411,23773,208615,77.03655835
8/6/2005,110925,72510,23741,207176,76.50516987
8/7/2005,110387,71517,23661,205565,75.91026588
8/8/2005,109835,70563,23605,204003,75.33345643
8/9/2005,109299,69649,23557,202505,74.78028065
8/10/2005,108733,68656,23493,200882,74.18094535
8/11/2005,108088,67742,23409,199239,73.57422452
8/12/2005,107508,66923,23358,197789,73.038774
8/13/2005,107124,66070,23346,196540,72.57754801
8/14/2005,106612,65192,23282,195086,72.04062038
8/15/2005,106148,64606,23298,194052,71.65878877
8/16/2005,105605,63892,23278,192775,71.18722304
8/17/2005,105114,63128,23215,191457,70.70051699
8/18/2005,104526,62339,23143,190008,70.16543575
8/19/2005,103956,61473,23080,188509,69.61189069
8/20/2005,103436,60671,23032,187139,69.10598227
8/21/2005,102916,59779,22980,185675,68.56536189
8/22/2005,102398,58802,22929,184129,67.99446086
8/23/2005,101882,57826,22858,182566,67.41728213
8/24/2005,101320,56898,22791,181009,66.84231905
8/25/2005,100745,56092,22725,179562,66.30797637
8/26/2005,100156,55200,22650,178006,65.73338257
8/27/2005,99552,54183,22579,176314,65.10856721
8/28/2005,98952,53225,22533,174710,64.51624815
8/29/2005,98399,52304,22509,173212,63.96307238
8/30/2005,97862,51651,22505,172018,63.52215657
8/31/2005,97434,51208,22595,171237,63.23375185
9/1/2005,96993,50823,22854,170670,63.02437223
9/2/2005,96552,50356,22949,169857,62.72415066
9/3/2005,96008,49737,22953,168698,62.29615953
9/4/2005,95448,48926,22909,167283,61.77363368
9/5/2005,94936,48158,22874,165968,61.28803545
9/6/2005,94381,47480,22810,164671,60.80908419
9/7/2005,93842,46735,22760,163337,60.31646972
9/8/2005,93259,45979,22673,161911,59.78988183
9/9/2005,92769,45145,22568,160482,59.26218612
9/10/2005,92219,44411,22400,159030,58.72599705
9/11/2005,91658,43722,22136,157516,58.16691285
9/12/2005,91291,43109,21888,156288,57.71344165
9/13/2005,90849,42373,21707,154929,57.21159527
9/14/2005,90292,41575,21443,153310,56.61373708
9/15/2005,89855,40913,21180,151948,56.11078287
9/16/2005,89374,40461,21010,150845,55.7034712
9/17/2005,88864,39610,20953,149427,55.17983752
9/18/2005,88273,38727,20905,147905,54.61779911
9/19/2005,87756,37896,20860,146512,54.10339734
9/20/2005,87166,37044,20795,145005,53.54689808
9/21/2005,86594,36231,20727,143552,53.01033973
9/22/2005,85995,35400,20663,142058,52.45864106
9/23/2005,85385,34577,20335,140297,51.80834564
9/24/2005,84791,33834,20061,138686,51.21344165
9/25/2005,84201,33102,19785,137088,50.62333826
9/26/2005,83611,32685,19518,135814,50.15288035
9/27/2005,83094,32249,19362,134705,49.74335303
9/28/2005,82483,31582,19166,133231,49.19903988
9/29/2005,81871,30933,18906,131710,48.63737075
9/30/2005,81319,30191,18597,130107,48.04542097
10/1/2005,80795,29292,18226,128313,47.38293944
10/2/2005,80220,28532,17858,126610,46.75406204
10/3/2005,79645,27851,17495,124991,46.15620384
10/4/2005,79046,26932,17120,123098,45.45716396
10/5/2005,78437,26192,16749,121378,44.82200886
10/6/2005,77829,25502,16381,119712,44.20679468
10/7/2005,77588,24890,16235,118713,43.83788774
10/8/2005,77655,24626,16688,118969,43.93242245
10/9/2005,78640,24805,20758,124203,45.86521418
10/10/2005,79128,24958,21641,125727,46.42799114
10/11/2005,79277,25018,22004,126299,46.63921713
10/12/2005,79332,25068,22093,126493,46.71085672
10/13/2005,79947,25510,23541,128998,47.63589365
10/14/2005,81278,26056,24891,132225,48.82754801
10/15/2005,82469,26618,25788,134875,49.80612999
10/16/2005,83625,27238,26414,137277,50.69313146
10/17/2005,84425,27698,26779,138902,51.29320532
10/18/2005,85046,28046,27051,140143,51.7514771
10/19/2005,85526,28337,27275,141138,52.11890694
10/20/2005,85867,28541,27438,141846,52.38035451
10/21/2005,86137,28680,27580,142397,52.5838257
10/22/2005,86408,28801,27714,142923,52.77806499
10/23/2005,87466,29283,28237,144986,53.53988183
10/24/2005,89024,30618,28615,148257,54.74778434
10/25/2005,90350,31628,29370,151348,55.88921713
10/26/2005,92694,33507,29878,156079,57.63626292
10/27/2005,94141,35083,30282,159506,58.90177253
10/28/2005,95357,36370,30579,162306,59.93574594
10/29/2005,96370,37381,30808,164559,60.76772526
10/30/2005,97176,38275,31021,166472,61.47415066
10/31/2005,97877,39054,31201,168132,62.08714919
11/1/2005,98537,39779,31391,169707,62.66875923
11/2/2005,99244,40483,31405,171132,63.19497784
11/3/2005,99877,41312,31340,172529,63.71085672
11/4/2005,100481,41953,31294,173728,64.15361891
11/5/2005,100978,42499,31183,174660,64.49778434
11/6/2005,101476,43025,31072,175573,64.83493353
11/7/2005,101976,43588,30952,176516,65.183161
11/8/2005,102148,44188,30831,177167,65.42355982
11/9/2005,102257,44700,30680,177637,65.59711965
11/10/2005,102476,45378,30621,178475,65.90657312
11/11/2005,102790,46312,30612,179714,66.36410635
11/12/2005,102900,47002,30511,180413,66.62223043
11/13/2005,103026,47647,30387,181060,66.86115214
11/14/2005,103073,48203,30255,181531,67.03508124
11/15/2005,103199,48792,30137,182128,67.25553914
11/16/2005,103183,49516,30028,182727,67.4767356
11/17/2005,104177,51173,30110,185460,68.4859675
11/18/2005,105048,53051,30171,188270,69.52363368
11/19/2005,105784,54463,30125,190372,70.29985229
11/20/2005,106356,55616,30046,192018,70.90768095
11/21/2005,106868,56580,29946,193394,71.41580502
11/22/2005,107300,57460,29860,194620,71.86853767
11/23/2005,107782,58387,29810,195979,72.37038405
11/24/2005,108152,59206,29707,197065,72.77141802
11/25/2005,108363,59853,29593,197809,73.04615953
11/26/2005,108568,60378,29469,198415,73.26994092
11/27/2005,108911,60842,29315,199068,73.51107829
11/28/2005,109251,61333,29172,199756,73.76514032
11/29/2005,109770,62046,29083,200899,74.18722304
11/30/2005,112037,63867,30487,206391,76.21528804
12/1/2005,114728,66974,31471,213173,78.71971935
12/2/2005,116093,69080,31911,217084,80.16395864
12/3/2005,117357,70642,32225,220224,81.32348597
12/4/2005,118304,71821,32465,222590,82.1971935
12/5/2005,119121,72788,32647,224556,82.92319055
12/6/2005,119784,73609,32829,226222,83.53840473
12/7/2005,120395,74326,32986,227707,84.08677991
12/8/2005,120480,75044,33115,228639,84.43094535
12/9/2005,121294,75611,33046,229951,84.91543575
12/10/2005,121626,76108,32924,230658,85.17651403
12/11/2005,121951,76550,32781,231282,85.40694239
12/12/2005,122309,76992,32638,231939,85.64955687
12/13/2005,122689,77393,32494,232576,85.88478582
12/14/2005,122791,77655,32302,232748,85.94830133
12/15/2005,122808,77862,32122,232792,85.96454948
12/16/2005,123067,78263,31986,233316,86.15805022
12/17/2005,122981,78761,32118,233860,86.35893648
12/18/2005,122756,79244,32232,234232,86.49630724
12/19/2005,122498,79521,32316,234335,86.53434269
12/20/2005,122258,79673,32391,234322,86.5295421
12/21/2005,122002,79797,32444,234243,86.50036928
12/22/2005,121557,80004,32458,234019,86.4176514
12/23/2005,121248,80156,32500,233904,86.37518464
12/24/2005,120949,80363,32542,233854,86.35672083
12/25/2005,120605,80570,32580,233755,86.32016248
12/26/2005,120497,81148,32733,234378,86.55022157
12/27/2005,121265,82189,32919,236373,87.28692762
12/28/2005,121488,83028,33048,237564,87.7267356
12/29/2005,121540,83663,33115,238318,88.00516987
12/30/2005,122670,85325,33446,241441,89.1584195
12/31/2005,124135,87378,33499,245012,90.47710487
1/1/2006,125331,88876,33461,247668,91.45790251
1/2/2006,126255,90123,33369,249747,92.22562777
1/3/2006,127146,91264,33317,251727,92.95679468
1/4/2006,127987,92314,33221,253522,93.61964549
1/5/2006,128409,93105,33101,254615,94.0232644
1/6/2006,129077,93866,32981,255924,94.50664697
1/7/2006,129642,94519,32834,256995,94.9021418
1/8/2006,130067,95113,32690,257870,95.22525849
1/9/2006,130475,95660,32533,258668,95.51994092
1/10/2006,130883,96109,32382,259374,95.78064993
1/11/2006,131291,96591,32236,260118,96.05539143
1/12/2006,131969,97057,32481,261507,96.5683161
1/13/2006,133168,97927,32805,263900,97.45199409
1/14/2006,134408,98394,33105,265907,98.19313146
1/15/2006,138022,100276,34586,272884,100.7695716
1/16/2006,140227,100373,35041,275641,101.7876662
1/17/2006,141486,99858,35140,276484,102.098966
1/18/2006,141969,99553,35199,276721,102.1864845
1/19/2006,144060,102192,35498,281750,104.0435746
1/20/2006,143013,101677,35264,279954,103.3803545
1/21/2006,142416,100743,35199,278358,102.7909897
1/22/2006,142043,99971,35165,277179,102.355613
1/23/2006,141839,99408,35165,276412,102.0723781
1/24/2006,141690,98973,35160,275823,101.8548744
1/25/2006,141449,98700,35110,275259,101.6466027
1/26/2006,141098,98442,35056,274596,101.4017725
1/27/2006,140875,98233,34976,274084,101.2127031
1/28/2006,140616,97991,34946,273553,101.0166174
1/29/2006,140505,97846,34941,273292,100.9202363
1/30/2006,140505,97814,34986,273305,100.9250369
1/31/2006,140616,97959,35036,273611,101.0380355
2/1/2006,140968,98474,35066,274508,101.3692762
2/2/2006,140875,98474,35021,274370,101.3183161
2/3/2006,140913,98523,35031,274467,101.3541359
2/4/2006,141319,99038,35204,275561,101.7581241
2/5/2006,141616,99263,35264,276143,101.9730428
2/6/2006,141839,99376,35239,276454,102.0878877
2/7/2006,141764,99183,35169,276116,101.9630724
2/8/2006,141653,98925,35140,275718,101.8161004
2/9/2006,141412,98651,35120,275183,101.6185377
2/10/2006,141061,98426,34917,274404,101.3308715
2/11/2006,140838,98233,34991,274062,101.204579
2/12/2006,140672,98007,34863,273542,101.0125554
2/13/2006,140560,97878,34665,273103,100.8504431
2/14/2006,140412,97734,34710,272856,100.7592319
2/15/2006,140153,97621,34724,272498,100.627031
2/16/2006,140024,97540,34739,272303,100.5550222
2/17/2006,139896,97476,34586,271958,100.4276219
2/18/2006,139748,97460,34379,271587,100.2906204
2/19/2006,139932,97347,34086,271365,100.2086411
2/20/2006,139951,97251,33775,270977,100.0653619
2/21/2006,139988,97202,33489,270679,99.95531758
2/22/2006,140006,97186,33523,270715,99.96861152
2/23/2006,139896,97073,33610,270579,99.91838996
2/24/2006,139601,97041,33698,270340,99.83013294
2/25/2006,139308,97009,33751,270068,99.72968981
2/26/2006,139013,96929,33803,269745,99.61041359
2/27/2006,138664,96848,33838,269350,99.46454948
2/28/2006,138058,96784,33654,268496,99.14918759
3/1/2006,137583,96752,33211,267546,98.79837518
3/2/2006,137182,96703,33115,267000,98.59675037
3/3/2006,136781,96703,33105,266589,98.44497784
3/4/2006,136363,96671,32919,265953,98.21011817
3/5/2006,135928,96671,32639,265238,97.94608567
3/6/2006,135475,96687,32377,264539,97.6879616
3/7/2006,135511,96703,32108,264322,97.60782866
3/8/2006,135566,96607,31832,264005,97.49076809
3/9/2006,135620,96302,31555,263477,97.29579025
3/10/2006,135710,96044,31285,263039,97.13404727
3/11/2006,135801,95948,30984,262733,97.02104874
3/12/2006,135892,95899,30616,262407,96.9006647
3/13/2006,136036,98754,30232,265022,97.86632201
3/14/2006,136073,96205,29932,262210,96.82791728
3/15/2006,136181,97395,29697,263273,97.2204579
3/16/2006,136272,97830,29428,263530,97.31536189
3/17/2006,136272,97975,29101,263348,97.24815362
3/18/2006,136272,97927,28747,262946,97.09970458
3/19/2006,136199,97830,28403,262432,96.9098966
3/20/2006,136127,97750,28058,261935,96.72636632
3/21/2006,135892,97508,27988,261388,96.52437223
3/22/2006,135747,97283,28027,261057,96.4021418
3/23/2006,135566,97170,28027,260763,96.29357459
3/24/2006,135403,97009,28045,260457,96.18057607
3/25/2006,135185,96913,28088,260186,96.08050222
3/26/2006,135004,96832,28119,259955,95.99519941
3/27/2006,134895,96800,28167,259862,95.96085672
3/28/2006,134588,96671,28185,259444,95.80649926
3/29/2006,134390,96463,28211,259064,95.6661743
3/30/2006,134120,96414,28202,258736,95.5450517
3/31/2006,133959,96302,28224,258485,95.45236337
4/1/2006,133725,96269,28255,258249,95.36521418
4/2/2006,133635,96414,28324,258373,95.41100443
4/3/2006,133527,96447,28394,258368,95.40915805
4/4/2006,133437,96382,28499,258318,95.39069424
4/5/2006,133455,96447,28628,258530,95.4689808
4/6/2006,133815,96463,28751,259029,95.65324963
4/7/2006,134246,96495,28844,259585,95.85856721
4/8/2006,134444,96687,28972,260103,96.04985229
4/9/2006,134570,96735,29088,260393,96.15694239
4/10/2006,134696,96752,29186,260634,96.24593796
4/11/2006,135022,96768,29271,261061,96.40361891
4/12/2006,135185,96752,29347,261284,96.4859675
4/13/2006,135493,96703,29415,261611,96.60672083
4/14/2006,135674,96687,29496,261857,96.69756278
4/15/2006,135910,96768,29598,262276,96.85228951
4/16/2006,136145,96880,29702,262727,97.01883309
4/17/2006,136181,96816,29778,262775,97.03655835
4/18/2006,136199,96719,29846,262764,97.03249631
4/19/2006,136272,96495,29914,262681,97.00184638
4/20/2006,136345,96237,29977,262559,96.95679468
4/21/2006,136345,96141,30050,262536,96.94830133
4/22/2006,136327,96109,30114,262550,96.9534712
4/23/2006,136908,96655,30337,263900,97.45199409
4/24/2006,139142,98700,31290,269132,99.38404727
4/25/2006,140523,99633,31785,271941,100.4213442
4/26/2006,141024,99633,32080,272737,100.715288
4/27/2006,141079,99311,32292,272682,100.6949778
4/28/2006,141227,98957,32458,272642,100.6802068
4/29/2006,141264,98603,32596,272463,100.6141064
4/30/2006,140931,98313,32709,271953,100.4257755
5/1/2006,140838,98040,32824,271702,100.3330871
5/2/2006,140764,97878,32924,271566,100.2828656
5/3/2006,140579,97798,32957,271334,100.1971935
5/4/2006,140338,97540,33038,270916,100.042836
5/5/2006,140098,97235,33144,270477,99.88072378
5/6/2006,139951,96961,33221,270133,99.75369276
5/7/2006,139896,96735,33264,269895,99.66580502
5/8/2006,139822,96527,33283,269632,99.56868538
5/9/2006,139693,96479,33302,269474,99.51033973
5/10/2006,139565,96623,33317,269505,99.5217873
5/11/2006,139400,96607,33336,269343,99.46196455
5/12/2006,139675,96752,33513,269940,99.68242245
5/13/2006,140061,96880,34463,271404,100.2230428
5/14/2006,140338,96929,34783,272050,100.4615953
5/15/2006,140505,96913,35001,272419,100.5978582
5/16/2006,140634,96880,35001,272515,100.6333087
5/17/2006,140987,96896,35155,273038,100.8264402
5/18/2006,140894,96929,35115,272938,100.7895126
5/19/2006,140931,96961,35090,272982,100.8057607
5/20/2006,140968,97057,35120,273145,100.8659527
5/21/2006,140968,97073,35075,273116,100.8552437
5/22/2006,141061,97186,35056,273303,100.9242984
5/23/2006,141042,97251,35026,273319,100.9302068
5/24/2006,140987,97267,35011,273265,100.9102659
5/25/2006,140950,97186,35001,273137,100.8629985
5/26/2006,140913,97170,34961,273044,100.8286558
5/27/2006,140950,97154,34877,272981,100.8053914
5/28/2006,140672,97138,34892,272702,100.7023634
5/29/2006,140431,97073,34863,272367,100.5786558
5/30/2006,140172,96977,34818,271967,100.4309453
5/31/2006,140301,96880,34769,271950,100.4246677
6/1/2006,140672,96880,34778,272330,100.5649926
6/2/2006,140950,96816,34705,272471,100.6170606
6/3/2006,141098,96880,34655,272633,100.6768833
6/4/2006,141116,97299,34670,273085,100.8437962
6/5/2006,141042,97476,34650,273168,100.8744461
6/6/2006,140931,97476,34576,272983,100.80613
6/7/2006,140783,97331,34557,272671,100.6909158
6/8/2006,140875,97235,34670,272780,100.7311669
6/9/2006,141301,97492,34833,273626,101.0435746
6/10/2006,141486,97685,34961,274132,101.2304284
6/11/2006,141653,97862,34981,274496,101.3648449
6/12/2006,141598,97878,34951,274427,101.3393648
6/13/2006,141449,97766,34818,274033,101.19387
6/14/2006,141245,97589,34778,273612,101.0384047
6/15/2006,141431,97573,34823,273827,101.1177991
6/16/2006,141375,97460,34808,273643,101.0498523
6/17/2006,140857,97122,34744,272723,100.7101182
6/18/2006,140579,96816,34660,272055,100.4634417
6/19/2006,140412,96495,34562,271469,100.2470458
6/20/2006,140375,96575,34463,271413,100.2263663
6/21/2006,140301,96431,34507,271239,100.1621123
6/22/2006,140098,96221,34517,270836,100.0132939
6/23/2006,139988,96205,34453,270646,99.94313146
6/24/2006,140214,96221,34405,270840,100.014771
6/25/2006,140505,96221,34355,271081,100.1037666
6/26/2006,141042,96736,34705,272483,100.6214919
6/27/2006,143873,99183,35613,278669,102.9058346
6/28/2006,145717,107541,35778,289036,106.7341211
6/29/2006,145039,108873,35514,289426,106.8781388
6/30/2006,143346,106023,35289,284658,105.1174298
7/1/2006,142435,101999,35204,279638,103.2636632
7/2/2006,141913,100405,35155,277473,102.4641802
7/3/2006,141635,99521,34951,276107,101.9597489
7/4/2006,141375,98555,34931,274861,101.4996307
7/5/2006,141319,97991,34907,274217,101.2618168
7/6/2006,141098,97573,34700,273371,100.9494092
7/7/2006,141005,97283,34463,272751,100.7204579
7/8/2006,140709,97009,34209,271927,100.4161743
7/9/2006,140486,96784,33988,271258,100.1691285
7/10/2006,140375,96543,33755,270673,99.95310192
7/11/2006,140172,96495,33669,270336,99.82865583
7/12/2006,140080,96527,33591,270198,99.77769572
7/13/2006,139951,96848,33538,270337,99.82902511
7/14/2006,139767,96945,33451,270163,99.76477105
7/15/2006,139528,96848,33297,269673,99.5838257
7/16/2006,139197,96655,33153,269005,99.33714919
7/17/2006,138885,96463,32995,268343,99.09268833
7/18/2006,138535,96141,32834,267510,98.78508124
7/19/2006,138113,95786,32634,266533,98.42429838
7/20/2006,137583,95722,32615,265920,98.19793205
7/21/2006,137090,95676,32491,265257,97.95310192
7/22/2006,136708,95676,32411,264795,97.78249631
7/23/2006,136526,96028,32477,265031,97.86964549
7/24/2006,136145,96173,32420,264738,97.76144756
7/25/2006,135692,96189,32339,264220,97.57016248
7/26/2006,135222,96092,32245,263559,97.3260709
7/27/2006,134823,96060,32151,263034,97.13220089
7/28/2006,134300,96044,32000,262344,96.8774003
7/29/2006,134624,96382,31869,262875,97.07348597
7/30/2006,134534,96623,31761,262918,97.08936484
7/31/2006,134426,96719,31639,262784,97.03988183
8/1/2006,134210,96623,31550,262383,96.89180207
8/2/2006,133815,96398,31327,261540,96.58050222
8/3/2006,133437,96092,31131,260660,96.25553914
8/4/2006,133060,95964,30845,259869,95.96344165
8/5/2006,132683,95931,30547,259161,95.70199409
8/6/2006,132218,95851,30259,258328,95.394387
8/7/2006,131755,95706,29923,257384,95.04579025
8/8/2006,131273,95569,29585,256427,94.69239291
8/9/2006,130777,95356,29244,255377,94.30465288
8/10/2006,130280,95220,28839,254339,93.92134417
8/11/2006,129766,95037,28495,253298,93.53692762
8/12/2006,129218,94702,28158,252078,93.08641064
8/13/2006,128655,94276,27805,250736,92.59084195
8/14/2006,128110,93927,27447,249484,92.12850812
8/15/2006,127565,93577,27116,248258,91.67577548
8/16/2006,127023,93212,26774,247009,91.21454948
8/17/2006,126499,92892,26435,245826,90.77769572
8/18/2006,125975,92466,26076,244517,90.29431315
8/19/2006,125401,91979,25725,243105,89.77289513
8/20/2006,126360,92466,25475,244301,90.21454948
8/21/2006,126709,92892,25197,244798,90.39807976
8/22/2006,126604,93029,24858,244491,90.28471196
8/23/2006,126360,92968,24507,243835,90.04246677
8/24/2006,126028,92755,24153,242936,89.71048744
8/25/2006,125679,92177,23777,241633,89.22932053
8/26/2006,125418,91903,23465,240786,88.91654357
8/27/2006,125174,91721,23155,240050,88.64475628
8/28/2006,125157,92055,22921,240133,88.6754062
8/29/2006,125019,92497,22709,240225,88.70937962
8/30/2006,126971,94474,22957,244402,90.25184638
8/31/2006,127829,95835,23072,246736,91.11373708
9/1/2006,128286,96591,23175,248052,91.59970458
9/2/2006,128585,96977,23266,248828,91.88626292
9/3/2006,128708,97073,23401,249182,92.01698671
9/4/2006,128725,97106,23541,249372,92.08714919
9/5/2006,128637,97122,23721,249480,92.12703102
9/6/2006,128620,97090,23817,249527,92.144387
9/7/2006,128514,97073,23906,249493,92.13183161
9/8/2006,128339,96945,23991,249275,92.05132939
9/9/2006,128093,96864,24051,249008,91.95273264
9/10/2006,127811,96768,24092,248671,91.82828656
9/11/2006,127495,96703,24076,248274,91.6816839
9/12/2006,127163,96623,24047,247833,91.51883309
9/13/2006,126796,96479,24051,247326,91.33161004
9/14/2006,126394,96463,24043,246900,91.17429838
9/15/2006,126604,96816,24871,248291,91.6879616
9/16/2006,126813,97235,25483,249531,92.14586411
9/17/2006,126831,97283,25762,249876,92.2732644
9/18/2006,126761,97267,25959,249987,92.31425406
9/19/2006,126586,97218,26118,249922,92.29025111
9/20/2006,126516,97073,26261,249850,92.26366322
9/21/2006,126342,96977,26363,249682,92.20162482
9/22/2006,126115,96896,26465,249476,92.12555391
9/23/2006,125800,96527,26545,248872,91.90251108
9/24/2006,125574,96092,26642,248308,91.69423929
9/25/2006,125331,95835,26723,247889,91.53951256
9/26/2006,124984,95448,26732,247164,91.2717873
9/27/2006,124690,95006,26697,246393,90.98707533
9/28/2006,124291,94626,26710,245627,90.70420975
9/29/2006,124516,94611,26701,245828,90.77843427
9/30/2006,124828,95022,26697,246547,91.04394387
10/1/2006,124949,95204,26719,246872,91.16395864
10/2/2006,125279,95539,26923,247741,91.48485968
10/3/2006,125418,95819,26979,248216,91.66026588
10/4/2006,125488,95851,27090,248429,91.73892171
10/5/2006,125540,95867,27202,248609,91.80539143
10/6/2006,125557,95867,27292,248716,91.84490399
10/7/2006,125453,95819,27369,248641,91.81720827
10/8/2006,125314,95676,27434,248424,91.73707533
10/9/2006,125157,95478,27494,248129,91.62813885
10/10/2006,124915,95250,27550,247715,91.47525849
10/11/2006,124690,94946,27584,247220,91.29246677
10/12/2006,124412,94747,27670,246829,91.14807976
10/13/2006,124378,94717,27826,246921,91.18205318
10/14/2006,124274,94367,27914,246555,91.04689808
10/15/2006,124153,94018,27983,246154,90.89881832
10/16/2006,123997,93637,28058,245692,90.7282127
10/17/2006,123859,93301,28114,245274,90.57385524
10/18/2006,124101,92755,28539,245395,90.61853767
10/19/2006,124274,92192,28897,245363,90.60672083
10/20/2006,124811,91766,29258,245835,90.7810192
10/21/2006,126290,92451,30060,248801,91.87629247
10/22/2006,127250,92938,30461,250649,92.55871492
10/23/2006,128040,93166,30744,251950,93.03914328
10/24/2006,128708,93501,30952,253161,93.48633678
10/25/2006,129201,93592,31136,253929,93.76994092
10/26/2006,129731,93683,31294,254708,94.05760709
10/27/2006,130103,93729,31424,255256,94.25997046
10/28/2006,130670,93942,31681,256293,94.6429099
10/29/2006,133240,97186,33543,263969,97.47747415
10/30/2006,134931,98378,34032,267341,98.72267356
10/31/2006,135312,98474,34287,268073,98.99298375
11/1/2006,135873,98410,34253,268536,99.16395864
11/2/2006,136399,98313,34170,268882,99.29172821
11/3/2006,136945,98233,34101,269279,99.43833087
11/4/2006,137236,97959,33959,269154,99.39217134
11/5/2006,137401,97540,33799,268740,99.23929099
11/6/2006,137601,97170,33611,268382,99.1070901
11/7/2006,137657,96848,33432,267937,98.94276219
11/8/2006,137638,96591,33221,267450,98.76292467
11/9/2006,138498,96703,33562,268763,99.24778434
11/10/2006,139050,96832,33674,269556,99.54062038
11/11/2006,139528,96784,33596,269908,99.67060561
11/12/2006,139917,96704,33713,270334,99.82791728
11/13/2006,140209,96655,33813,270677,99.95457903
11/14/2006,140357,96607,33925,270889,100.0328656
11/15/2006,140486,96559,34037,271082,100.1041359
11/16/2006,140486,96414,34135,271035,100.0867799
11/17/2006,141616,99247,35061,275924,101.8921713
11/18/2006,141746,100083,35269,277098,102.3257016
11/19/2006,141598,99826,35229,276653,102.1613737
11/20/2006,141301,99360,35194,275855,101.8666913
11/21/2006,141024,98941,35150,275115,101.5934269
11/22/2006,140857,98603,35100,274560,101.3884786
11/23/2006,140746,98345,34941,274032,101.1935007
11/24/2006,140875,98265,34798,273938,101.1587888
11/25/2006,140765,97959,34601,273325,100.9324225
11/26/2006,140653,97492,34414,272559,100.6495569
11/27/2006,140560,97170,34189,271919,100.4132201
11/28/2006,140486,96800,33964,271250,100.1661743
11/29/2006,140634,96591,33731,270956,100.0576071
11/30/2006,140746,96398,33499,270643,99.94202363
12/1/2006,140708,96253,33259,270220,99.78581979
12/2/2006,141283,96414,33201,270898,100.0361891
12/3/2006,141135,96511,33062,270708,99.96602659
12/4/2006,140950,96398,32885,270233,99.79062038
12/5/2006,140844,96334,32743,269921,99.6754062
12/6/2006,140486,96173,32567,269226,99.41875923
12/7/2006,140246,95980,32386,268612,99.19202363
12/8/2006,140043,95835,32227,268105,99.00480059
12/9/2006,139730,95660,32033,267423,98.75295421
12/10/2006,139436,95508,31850,266794,98.52067947
12/11/2006,139032,95265,31648,265945,98.20716396
12/12/2006,138645,95037,31639,265321,97.9767356
12/13/2006,138094,94748,31686,264528,97.68389956
12/14/2006,137547,94580,31789,263916,97.45790251
12/15/2006,136945,94337,31868,263150,97.17503693
12/16/2006,136290,93972,31939,262201,96.8245938
12/17/2006,135711,93713,32000,261424,96.53766617
12/18/2006,135058,93348,32052,260458,96.18094535
12/19/2006,134437,93059,32114,259610,95.86779911
12/20/2006,133725,92679,32066,258470,95.44682422
12/21/2006,133132,92268,31906,257306,95.01698671
12/22/2006,132469,91918,31906,256293,94.6429099
12/23/2006,131933,91614,32019,255566,94.37444609
12/24/2006,131635,91416,32254,255305,94.27806499
12/25/2006,131291,91218,32358,254867,94.11632201
12/26/2006,131078,90975,32477,254530,93.99187592
12/27/2006,131081,90929,32662,254672,94.04431315
12/28/2006,130795,90853,32786,254434,93.95642541
12/29/2006,130599,90792,32866,254257,93.89106352
12/30/2006,130422,90807,32962,254191,93.86669129
12/31/2006,130245,91005,33048,254298,93.90620384
1/1/2007,130138,91188,33173,254499,93.98042836
1/2/2007,130085,91203,33417,254705,94.05649926
1/3/2007,130067,91081,33437,254585,94.01218612
1/4/2007,130067,90914,33374,254355,93.92725258
1/5/2007,130049,90701,33336,254086,93.82791728
1/6/2007,130635,90899,33393,254927,94.13847858
1/7/2007,132308,91705,33974,257987,95.26846381
1/8/2007,133419,92299,34306,260024,96.02067947
1/9/2007,135130,93455,34907,263492,97.30132939
1/10/2007,136109,94307,34902,265318,97.97562777
1/11/2007,136690,94824,34749,266263,98.3245938
1/12/2007,137000,95234,34562,266796,98.52141802
1/13/2007,137273,95539,34345,267157,98.65472674
1/14/2007,137748,96012,34170,267930,98.94017725
1/15/2007,138223,96543,34028,268794,99.25923191
1/16/2007,139509,97878,34160,271547,100.2758493
1/17/2007,140394,98281,34106,272781,100.7315362
1/18/2007,140783,98184,33920,272887,100.7706795
1/19/2007,140894,97991,33727,272612,100.6691285
1/20/2007,140765,97653,33616,272034,100.4556869
1/21/2007,140579,97396,33514,271489,100.2544313
1/22/2007,140394,97106,33379,270879,100.0291728
1/23/2007,140264,96832,33221,270317,99.82163959
1/24/2007,139914,96494,33192,269600,99.55686854
1/25/2007,139546,96221,33163,268930,99.30945347
1/26/2007,139068,95867,33096,268031,98.97747415
1/27/2007,138553,95463,33043,267059,98.61853767
1/28/2007,138168,95219,33024,266411,98.37924668
1/29/2007,137693,94793,33000,265486,98.03766617
1/30/2007,137145,94337,32914,264396,97.6351551
1/31/2007,136636,93820,32862,263318,97.23707533
2/1/2007,136127,93364,32866,262357,96.88220089
2/2/2007,135475,92862,32767,261104,96.41949778
2/3/2007,134805,92436,32667,259908,95.97784343
2/4/2007,134066,91994,32676,258736,95.5450517
2/5/2007,133329,91492,32671,257492,95.08567208
2/6/2007,132665,90990,32533,256188,94.60413589
2/7/2007,131862,90397,32391,254650,94.03618907
2/8/2007,131149,89773,32311,253233,93.51292467
2/9/2007,130493,89210,32213,251916,93.02658789
2/10/2007,129908,88906,32108,250922,92.65952733
2/11/2007,129394,88876,32108,250378,92.45864106
2/12/2007,128972,88845,32103,249920,92.28951256
2/13/2007,128514,88678,31976,249168,92.01181684
2/14/2007,128198,88556,31803,248557,91.78618907
2/15/2007,127952,88632,31634,248218,91.66100443
2/16/2007,127565,88419,31429,247413,91.36373708
2/17/2007,127198,88100,31350,246648,91.08124077
2/18/2007,126796,87609,31345,245750,90.74963072
2/19/2007,126412,87161,31332,244905,90.43759232
2/20/2007,126062,86496,31318,243876,90.05760709
2/21/2007,125696,85904,31197,242797,89.65915805
2/22/2007,125679,85152,31095,241926,89.33751846
2/23/2007,125453,84357,30984,240794,88.91949778
2/24/2007,125123,83504,30864,239491,88.43833087
2/25/2007,124759,82753,30854,238366,88.02289513
2/26/2007,124430,81958,30845,237233,87.60450517
2/27/2007,124065,81380,30721,236166,87.21048744
2/28/2007,123722,80806,30607,235135,86.82976366
3/1/2007,123394,80433,30470,234297,86.52031019
3/2/2007,123118,80101,30401,233620,86.27031019
3/3/2007,123084,80018,30487,233589,86.25886263
3/4/2007,123101,80281,30579,233961,86.39623338
3/5/2007,122894,80447,30616,233957,86.39475628
3/6/2007,122601,80405,30520,233526,86.23559823
3/7/2007,122292,80060,30396,232748,85.94830133
3/8/2007,121968,79645,30273,231886,85.62998523
3/9/2007,121677,79078,30168,230923,85.27437223
3/10/2007,121368,78512,30055,229935,84.90952733
3/11/2007,121214,78429,30073,229716,84.82865583
3/12/2007,121077,78457,30114,229648,84.80354505
3/13/2007,120924,78457,30028,229409,84.71528804
3/14/2007,120958,78761,29995,229714,84.82791728
3/15/2007,122498,80709,30222,233429,86.19977843
3/16/2007,126254,86771,30831,243856,90.05022157
3/17/2007,128286,89971,31141,249398,92.09675037
3/18/2007,129660,91644,31336,252640,93.29394387
3/19/2007,130581,92512,31466,254559,94.00258493
3/20/2007,130989,93136,31555,255680,94.41654357
3/21/2007,131113,93516,31532,256161,94.59416544
3/22/2007,131149,93698,31475,256322,94.65361891
3/23/2007,131951,94854,31532,258337,95.39771049
3/24/2007,132934,96864,31658,261456,96.54948301
3/25/2007,134426,98490,31915,264831,97.79579025
3/26/2007,135874,99697,32241,267812,98.89660266
3/27/2007,137748,100663,32538,270949,100.0550222
3/28/2007,140486,101484,33441,275411,101.7027326
3/29/2007,141857,101452,34243,277552,102.493353
3/30/2007,142099,100776,34665,277540,102.4889217
3/31/2007,141857,100051,34951,276859,102.2374446
4/1/2007,141524,99150,35100,275774,101.8367799
4/2/2007,141227,98523,35125,274875,101.5048006
4/3/2007,140876,98007,35185,274068,101.2067947
4/4/2007,140708,97669,35090,273467,100.9848597
4/5/2007,140783,97637,35175,273595,101.032127
4/6/2007,140671,97524,35090,273285,100.9176514
4/7/2007,140523,97315,35055,272893,100.7728951
4/8/2007,140338,97090,35060,272488,100.6233383
4/9/2007,140098,96848,35045,271991,100.439808
4/10/2007,139840,96655,35036,271531,100.2699409
4/11/2007,139601,96382,35060,271043,100.0897341
4/12/2007,139326,96140,35085,270551,99.90805022
4/13/2007,139013,96301,35090,270404,99.85376662
4/14/2007,138811,96398,34976,270185,99.77289513
4/15/2007,138609,96398,34897,269904,99.66912851
4/16/2007,141783,97798,35983,275564,101.7592319
4/17/2007,143406,99553,35518,278477,102.8349335
4/18/2007,143200,100502,35284,278986,103.0228951
4/19/2007,142826,100937,35204,278967,103.0158789
4/20/2007,142715,101226,35209,279150,103.0834564
4/21/2007,142547,100985,35204,278736,102.9305761
4/22/2007,142248,100470,35209,277927,102.6318316
4/23/2007,141987,99826,35209,277022,102.2976366
4/24/2007,141764,99182,35150,276096,101.9556869
4/25/2007,141431,98571,35050,275052,101.5701625
4/26/2007,141172,98249,35026,274447,101.3467504
4/27/2007,140801,97927,34981,273709,101.0742245
4/28/2007,140876,97412,34892,273180,100.8788774
4/29/2007,140913,96945,34670,272528,100.6381093
4/30/2007,140838,96591,34463,271892,100.4032496
5/1/2007,140765,96269,34262,271296,100.183161
5/2/2007,140597,96092,34301,270990,100.0701625
5/3/2007,140597,96044,34340,270981,100.066839
5/4/2007,140653,95770,34291,270714,99.96824225
5/5/2007,140597,95630,34316,270543,99.90509601
5/6/2007,140436,95630,34399,270465,99.87629247
5/7/2007,140283,95600,34473,270356,99.83604136
5/8/2007,140140,95600,34438,270178,99.77031019
5/9/2007,139951,95508,34404,269863,99.65398818
5/10/2007,139804,95523,34345,269672,99.58345643
5/11/2007,139804,95615,34360,269779,99.62296898
5/12/2007,139767,95851,34394,270012,99.70901034
5/13/2007,139619,95915,34468,270002,99.70531758
5/14/2007,139472,95931,34538,269941,99.68279173
5/15/2007,139271,95899,34503,269673,99.5838257
5/16/2007,139472,95722,34350,269544,99.53618907
5/17/2007,139583,95738,34330,269651,99.57570162
5/18/2007,139455,95738,34267,269460,99.50516987
5/19/2007,139216,95738,34204,269158,99.39364845
5/20/2007,139252,95630,34228,269110,99.37592319
5/21/2007,139234,95615,34262,269111,99.37629247
5/22/2007,139087,95493,34199,268779,99.25369276
5/23/2007,138829,95326,34130,268285,99.07127031
5/24/2007,138682,95219,34057,267958,98.95051699
5/25/2007,138443,95022,33969,267434,98.75701625
5/26/2007,138332,94733,33770,266835,98.53581979
5/27/2007,138113,94474,33606,266193,98.29874446
5/28/2007,137985,94291,33456,265732,98.12850812
5/29/2007,137784,94033,33283,265100,97.89512555
5/30/2007,137364,93698,33144,264206,97.56499261
5/31/2007,137108,93455,33077,263640,97.35598227
6/1/2007,136854,93120,32995,262969,97.10819793
6/2/2007,136581,92694,32905,262180,96.816839
6/3/2007,136472,92420,32876,261768,96.66469719
6/4/2007,136526,92451,32900,261877,96.7049483
6/5/2007,136781,92420,33057,262258,96.84564254
6/6/2007,136763,92238,33067,262068,96.77548006
6/7/2007,136617,92055,33067,261739,96.65398818
6/8/2007,136435,91659,33053,261147,96.43537666
6/9/2007,136235,91218,33033,260486,96.19128508
6/10/2007,135982,90807,33005,259794,95.93574594
6/11/2007,135638,90382,32977,258997,95.64143279
6/12/2007,135348,89925,32895,258168,95.33530281
6/13/2007,134895,89408,32819,257122,94.94903988
6/14/2007,134498,88967,32733,256198,94.60782866
6/15/2007,134192,88404,32662,255258,94.26070901
6/16/2007,133923,87695,32619,254237,93.88367799
6/17/2007,133707,87146,32567,253420,93.58197932
6/18/2007,133437,86742,32510,252689,93.3120384
6/19/2007,133042,86438,32396,251876,93.01181684
6/20/2007,135058,86178,32377,253613,93.65324963
6/21/2007,135783,86005,32189,253977,93.78766617
6/22/2007,136326,85542,31976,253844,93.73855244
6/23/2007,136563,85022,31597,253182,93.49409158
6/24/2007,136781,84545,31206,252532,93.25406204
6/25/2007,136927,83894,30836,251657,92.93094535
6/26/2007,136799,83287,30447,250533,92.51587888
6/27/2007,136290,82738,30292,249320,92.06794682
6/28/2007,136000,82290,30128,248418,91.73485968
6/29/2007,135602,81828,30019,247449,91.37703102
6/30/2007,134949,81524,29856,246329,90.96344165
7/1/2007,134228,81177,29792,245197,90.54542097
7/2/2007,133455,80847,29719,244021,90.11115214
7/3/2007,132880,80516,29549,242945,89.71381093
7/4/2007,132308,80308,29428,242044,89.38109306
7/5/2007,132022,80143,29405,241570,89.20605613
7/6/2007,131648,79963,29419,241030,89.00664697
7/7/2007,131167,79714,29333,240214,88.70531758
7/8/2007,130688,79327,29275,239290,88.36410635
7/9/2007,130226,78940,29199,238365,88.02252585
7/10/2007,129731,78498,29079,237308,87.63220089
7/11/2007,129236,77973,28946,236155,87.20642541
7/12/2007,128778,77710,28839,235327,86.9006647
7/13/2007,128146,77213,28760,234119,86.45457903
7/14/2007,127512,76771,28681,232964,86.02806499
7/15/2007,126953,76233,28609,231795,85.59638109
7/16/2007,126464,75721,28526,230711,85.19608567
7/17/2007,125905,75196,28455,229556,84.76957164
7/18/2007,125453,74685,28390,228528,84.38995569
7/19/2007,125001,74381,28342,227724,84.09305761
7/20/2007,124551,73940,28307,226798,83.75110783
7/21/2007,123945,73715,28250,225910,83.42319055
7/22/2007,123428,73199,28180,224807,83.01587888
7/23/2007,122929,72907,28105,223941,82.69608567
7/24/2007,122533,72589,28114,223236,82.43574594
7/25/2007,122138,72258,28136,222532,82.17577548
7/26/2007,121677,71861,28076,221614,81.83677991
7/27/2007,121197,71424,28005,220626,81.47193501
7/28/2007,120855,71318,27962,220135,81.29062038
7/29/2007,120463,71079,27944,219486,81.05096012
7/30/2007,120038,70801,28014,218853,80.81720827
7/31/2007,119546,70483,28023,218052,80.52141802
8/1/2007,119036,70033,27949,217018,80.13958641
8/2/2007,118545,69582,27883,216010,79.76735598
8/3/2007,118107,69159,27813,215079,79.42355982
8/4/2007,117619,68669,27732,214020,79.03249631
8/5/2007,117048,68099,27640,212787,78.57717873
8/6/2007,116545,67635,27546,211726,78.18537666
8/7/2007,116043,67203,27442,210688,77.80206795
8/8/2007,115659,66770,27412,209841,77.48929099
8/9/2007,115194,66337,27404,208935,77.15472674
8/10/2007,114911,66045,27421,208377,76.94867061
8/11/2007,114812,65968,27572,208352,76.9394387
8/12/2007,114412,65790,27615,207817,76.74187592
8/13/2007,114031,65472,27584,207087,76.47230428
8/14/2007,113749,65064,27511,206324,76.19054653
8/15/2007,113239,64580,27438,205257,75.7965288
8/16/2007,112794,64186,27391,204371,75.46935007
8/17/2007,112580,63842,27378,203800,75.25849335
8/18/2007,112152,63370,27356,202878,74.91802068
8/19/2007,111726,63027,27309,202062,74.61669129
8/20/2007,111301,62670,27249,201220,74.30576071
8/21/2007,110958,62314,27210,200482,74.03323486
8/22/2007,110631,62033,27202,199866,73.80576071
8/23/2007,110208,61817,27172,199197,73.55871492
8/24/2007,109754,61549,27133,198436,73.27769572
8/25/2007,109396,61205,27094,197695,73.00406204
8/26/2007,109089,60817,27031,196937,72.72415066
8/27/2007,108669,60402,26979,196050,72.39660266
8/28/2007,108298,59975,26927,195200,72.08271787
8/29/2007,107863,59560,26868,194291,71.74704579
8/30/2007,107476,59059,26795,193330,71.39217134
8/31/2007,107028,58424,26744,192196,70.97341211
9/1/2007,106468,57630,26697,190795,70.45605613
9/2/2007,106132,56959,26642,189733,70.06388479
9/3/2007,105589,56202,26570,188361,69.55723781
9/4/2007,105082,55616,26503,187201,69.1288774
9/5/2007,104494,55250,26278,186022,68.69350074
9/6/2007,103909,54932,25950,184791,68.23892171
9/7/2007,103357,54591,25637,183585,67.79357459
9/8/2007,102806,54217,25238,182261,67.30465288
9/9/2007,102539,53914,24842,181295,66.94793205
9/10/2007,102179,53809,24486,180474,66.64475628
9/11/2007,101851,53681,24185,179717,66.36521418
9/12/2007,102242,54241,24238,180721,66.7359675
9/13/2007,102117,54311,24222,180650,66.70974889
9/14/2007,101867,54252,24177,180296,66.57902511
9/15/2007,101633,53937,24120,179690,66.35524372
9/16/2007,101460,53867,24088,179415,66.25369276
9/17/2007,101164,53891,24031,179086,66.13220089
9/18/2007,100761,53786,23983,178530,65.92688331
9/19/2007,100404,53587,23914,177905,65.69608567
9/20/2007,100001,53366,23854,177221,65.44350074
9/21/2007,99614,53050,23789,176453,65.1598966
9/22/2007,99151,52595,23725,175471,64.79726736
9/23/2007,98705,52094,23669,174468,64.42688331
9/24/2007,98245,51709,23597,173551,64.08825702
9/25/2007,97755,51289,23529,172573,63.72710487
9/26/2007,97282,50834,23461,171577,63.35930576
9/27/2007,96825,50227,23389,170441,62.93980798
9/28/2007,96917,49702,23358,169977,62.76846381
9/29/2007,96825,49597,23294,169716,62.67208272
9/30/2007,96521,49119,23211,168851,62.35265879
10/1/2007,96144,48581,23135,167860,61.98670606
10/2/2007,96295,47814,23020,167129,61.71676514
10/3/2007,96385,47035,22874,166294,61.4084195
10/4/2007,96114,46235,22744,165093,60.96491876
10/5/2007,95735,45367,22717,163819,60.49446086
10/6/2007,95297,44511,22682,162490,60.00369276
10/7/2007,95010,43688,22650,161348,59.58197932
10/8/2007,94725,42973,22630,160328,59.20531758
10/9/2007,94471,42310,22595,159376,58.85376662
10/10/2007,94351,41953,22591,158895,58.67614476
10/11/2007,94171,41753,22619,158543,58.54615953
10/12/2007,94066,42237,22646,158949,58.69608567
10/13/2007,93961,42720,22694,159375,58.85339734
10/14/2007,93767,43109,22709,159585,58.93094535
10/15/2007,93557,43435,22713,159705,58.97525849
10/16/2007,93288,43766,22702,159756,58.99409158
10/17/2007,92961,43988,22682,159631,58.94793205
10/18/2007,92679,44155,22669,159503,58.9006647
10/19/2007,92382,44411,22615,159408,58.86558346
10/20/2007,92501,44722,22866,160089,59.11706056
10/21/2007,92650,45067,23107,160824,59.38847858
10/22/2007,92620,45390,23219,161229,59.53803545
10/23/2007,92487,45668,23294,161449,59.61927622
10/24/2007,92472,45946,23314,161732,59.72378139
10/25/2007,92724,46557,23397,162678,60.07311669
10/26/2007,92799,46980,23457,163236,60.27917282
10/27/2007,92932,47458,23549,163939,60.538774
10/28/2007,95071,49329,24748,169148,62.46233383
10/29/2007,96204,51126,25118,172448,63.68094535
10/30/2007,96886,52409,25313,174608,64.47858198
10/31/2007,97252,53459,25449,176160,65.05169867
11/1/2007,97480,54288,25537,177305,65.47451994
11/2/2007,97603,54969,25612,178184,65.79911374
11/3/2007,97618,55628,25671,178917,66.06979321
11/4/2007,97571,56165,25725,179461,66.27067947
11/5/2007,97480,56629,25775,179884,66.42688331
11/6/2007,97511,57154,25850,180515,66.6598966
11/7/2007,97603,57985,26026,181614,67.06573117
11/8/2007,97603,58485,26106,182194,67.27991137
11/9/2007,97495,58778,26026,182299,67.31868538
11/10/2007,97419,59218,25967,182604,67.43131462
11/11/2007,97298,59645,25913,182856,67.52437223
11/12/2007,97115,60048,25834,182997,67.57644018
11/13/2007,97069,60390,25775,183234,67.66395864
11/14/2007,97252,60866,25871,183989,67.94276219
11/15/2007,97404,61419,26156,184979,68.30834564
11/16/2007,99336,62810,27322,189468,69.96602659
11/17/2007,100435,64109,27710,192254,70.99483013
11/18/2007,101086,65497,27927,194510,71.82791728
11/19/2007,101538,66477,28076,196091,72.41174298
11/20/2007,102320,67371,28245,197936,73.09305761
11/21/2007,103357,68285,28486,200128,73.90251108
11/22/2007,104098,69358,28690,202146,74.64771049
11/23/2007,104399,70258,28870,203527,75.15768095
11/24/2007,104590,70987,28999,204576,75.5450517
11/25/2007,104685,71676,29119,205480,75.8788774
11/26/2007,104875,72391,29248,206514,76.26070901
11/27/2007,106180,73715,29647,209542,77.3788774
11/28/2007,107444,75390,29814,212648,78.52584934
11/29/2007,108395,76398,29787,214580,79.23929099
11/30/2007,108959,77448,29910,216317,79.88072378
12/1/2007,109186,78498,30064,217748,80.40915805
12/2/2007,109364,79341,30191,218896,80.83308715
12/3/2007,109543,80115,30346,220004,81.2422452
12/4/2007,109916,80874,30542,221332,81.73264402
12/5/2007,110436,81625,30680,222741,82.25295421
12/6/2007,110941,82305,30795,224041,82.73301329
12/7/2007,111089,82767,30900,224756,82.99704579
12/8/2007,111040,83157,30818,225015,83.09268833
12/9/2007,110908,83692,30712,225312,83.20236337
12/10/2007,110794,84299,30621,225714,83.35081241
12/11/2007,111138,84733,30552,226423,83.61262925
12/12/2007,111677,85253,30401,227331,83.94793205
12/13/2007,112464,86424,30268,229156,84.62186115
12/14/2007,112778,87320,30100,230198,85.00664697
12/15/2007,113371,88115,29865,231351,85.43242245
12/16/2007,113997,88861,29634,232492,85.85376662
12/17/2007,114595,89423,29432,233450,86.20753323
12/18/2007,115041,89910,29222,234173,86.47451994
12/19/2007,115476,89804,29044,234324,86.53028065
12/20/2007,115809,89256,28800,233865,86.36078287
12/21/2007,116160,88617,28530,233307,86.15472674
12/22/2007,116528,87898,28258,232684,85.92466765
12/23/2007,116863,87334,27988,232185,85.74039882
12/24/2007,119461,89043,28570,237074,87.54579025
12/25/2007,121436,91081,28659,241176,89.0605613
12/26/2007,122705,91933,28655,243293,89.84231905
12/27/2007,123653,92375,28583,244611,90.32902511
12/28/2007,124516,92740,28425,245681,90.72415066
12/29/2007,125331,92907,28609,246847,91.15472674
12/30/2007,126149,93196,28950,248295,91.6894387
12/31/2007,126953,93333,29199,249485,92.1288774
1/1/2008,127372,93288,29172,249832,92.25701625
1/2/2008,127706,93075,29079,249860,92.26735598
1/3/2008,127794,92679,28924,249397,92.09638109
1/4/2008,127829,92009,28968,248806,91.87813885
1/5/2008,127917,91431,28839,248187,91.64955687
1/6/2008,127970,90883,28720,247573,91.42282127
1/7/2008,128058,90564,28601,247223,91.29357459
1/8/2008,128497,90503,28548,247548,91.41358936
1/9/2008,129324,91066,28614,249004,91.95125554
1/10/2008,130866,92086,28964,251916,93.02658789
1/11/2008,132165,93120,29257,254542,93.99630724
1/12/2008,134102,95387,29710,259199,95.71602659
1/13/2008,135294,96607,30023,261924,96.72230428
1/14/2008,136308,97090,30310,263708,97.38109306
1/15/2008,136981,97283,30273,264537,97.68722304
1/16/2008,137328,97122,30137,264587,97.70568685
1/17/2008,137565,96848,29955,264368,97.62481536
1/18/2008,137766,96559,29778,264103,97.52695716
1/19/2008,137748,96253,29856,263857,97.43611521
1/20/2008,137510,95931,29968,263409,97.27067947
1/21/2008,137108,95447,30037,262592,96.9689808
1/22/2008,136726,94946,30110,261782,96.66986706
1/23/2008,136381,94383,30186,260950,96.36262925
1/24/2008,136018,93911,30255,260184,96.07976366
1/25/2008,135584,93333,30319,259236,95.72968981
1/26/2008,135130,92740,30350,258220,95.35450517
1/27/2008,134696,92101,30392,257189,94.97378139
1/28/2008,134156,91462,30438,256056,94.55539143
1/29/2008,133671,90823,30461,254955,94.14881832
1/30/2008,133150,90229,30470,253849,93.74039882
1/31/2008,132791,89804,30510,253105,93.46565731
2/1/2008,132326,89226,30547,252099,93.09416544
2/2/2008,132182,89134,30487,251803,92.98485968
2/3/2008,131862,89104,30373,251339,92.81351551
2/4/2008,131505,88754,30236,250495,92.50184638
2/5/2008,131043,88480,30195,249718,92.21491876
2/6/2008,131487,89530,30451,251468,92.86115214
2/7/2008,134228,93774,31686,259688,95.89660266
2/8/2008,136599,96832,32439,265870,98.17946824
2/9/2008,137820,97750,32752,268322,99.08493353
2/10/2008,138719,97878,32967,269564,99.54357459
2/11/2008,139234,97557,33144,269935,99.68057607
2/12/2008,139455,97090,33274,269819,99.63774003
2/13/2008,139730,96575,33392,269697,99.59268833
2/14/2008,141061,96929,33997,271987,100.4383309
2/15/2008,141209,96993,34276,272478,100.6196455
2/16/2008,141116,96736,34419,272271,100.5432053
2/17/2008,140894,96317,34513,271724,100.3412112
2/18/2008,141524,96478,34769,272771,100.7278434
2/19/2008,142528,98587,35329,276444,102.084195
2/20/2008,142136,98490,35185,275811,101.8504431
2/21/2008,141746,98023,35120,274889,101.5099705
2/22/2008,141394,97492,35085,273971,101.1709749
2/23/2008,141116,97041,35080,273237,100.8999261
2/24/2008,140820,96655,35050,272525,100.6370015
2/25/2008,140671,96205,35036,271912,100.4106352
2/26/2008,140542,95899,35070,271511,100.2625554
2/27/2008,140523,95645,35065,271233,100.1598966
2/28/2008,140394,95311,35001,270706,99.96528804
2/29/2008,140209,94793,34966,269968,99.69276219
3/1/2008,140153,94276,34971,269400,99.48301329
3/2/2008,139987,93729,34966,268682,99.21787297
3/3/2008,139877,93120,34941,267938,98.94313146
3/4/2008,139748,92542,34922,267212,98.67503693
3/5/2008,141727,93759,35229,270715,99.96861152
3/6/2008,143200,99070,35434,277704,102.549483
3/7/2008,142734,99697,35224,277655,102.5313885
3/8/2008,142882,100792,35314,278988,103.0236337
3/9/2008,144286,102949,35738,282973,104.4951994
3/10/2008,143182,102578,35324,281084,103.7976366
3/11/2008,142435,101226,35194,278855,102.9745199
3/12/2008,142024,100244,35150,277418,102.44387
3/13/2008,141691,99553,35090,276334,102.0435746
3/14/2008,141283,98812,34966,275061,101.573486
3/15/2008,141005,98168,34848,274021,101.1894387
3/16/2008,140801,97653,34793,273247,100.9036189
3/17/2008,140708,97202,34684,272594,100.6624815
3/18/2008,140634,96784,34533,271951,100.4250369
3/19/2008,140579,96414,34542,271535,100.271418
3/20/2008,141727,97283,35244,274254,101.2754801
3/21/2008,142211,98329,35254,275794,101.8441654
3/22/2008,142043,98394,35090,275527,101.7455687
3/23/2008,141764,98023,35026,274813,101.4819055
3/24/2008,141394,97621,34971,273986,101.176514
3/25/2008,140950,97170,34887,273007,100.8149926
3/26/2008,140690,96607,34764,272061,100.4656573
3/27/2008,140560,96317,34695,271572,100.2850812
3/28/2008,140560,96140,34621,271321,100.1923929
3/29/2008,140727,96173,34606,271506,100.260709
3/30/2008,140597,95996,34497,271090,100.1070901
3/31/2008,140449,95754,34350,270553,99.90878877
4/1/2008,140950,96334,34365,271649,100.3135155
4/2/2008,141524,97283,34961,273768,101.0960118
4/3/2008,141449,97750,35090,274289,101.2884047
4/4/2008,141320,97830,35065,274215,101.2610783
4/5/2008,141635,98281,35185,275101,101.588257
4/6/2008,141617,98426,35170,275213,101.629616
4/7/2008,141449,98136,35110,274695,101.4383309
4/8/2008,141264,97798,35090,274152,101.2378139
4/9/2008,141116,97299,35050,273465,100.9841211
4/10/2008,141023,96961,35041,273025,100.8216396
4/11/2008,140876,96639,35036,272551,100.6466027
4/12/2008,140950,96430,35031,272411,100.594904
4/13/2008,140876,96253,35016,272145,100.4966765
4/14/2008,140820,96012,34902,271734,100.344904
4/15/2008,140597,95738,34715,271050,100.0923191
4/16/2008,140190,95371,34557,270118,99.74815362
4/17/2008,139877,95189,34355,269421,99.49076809
4/18/2008,139712,95158,34170,269040,99.35007386
4/19/2008,139619,95387,33934,268940,99.31314623
4/20/2008,139491,95691,33713,268895,99.2965288
4/21/2008,139381,95899,33504,268784,99.25553914
4/22/2008,139105,95931,33365,268401,99.11410635
4/23/2008,138811,95493,33321,267625,98.82754801
4/24/2008,138480,94961,33317,266758,98.50738552
4/25/2008,138351,94641,33326,266318,98.34490399
4/26/2008,137966,94352,33393,265711,98.12075332
4/27/2008,137784,94200,33480,265464,98.0295421
4/28/2008,137565,93972,33563,265100,97.89512555
4/29/2008,137657,94185,33819,265661,98.10228951
4/30/2008,137383,94459,33993,265835,98.16654357
5/1/2008,137181,94733,34057,265971,98.21676514
5/2/2008,136981,94641,34135,265757,98.13774003
5/3/2008,136890,94459,34219,265568,98.06794682
5/4/2008,136872,94337,34311,265520,98.05022157
5/5/2008,136890,94307,34414,265611,98.0838257
5/6/2008,136726,94155,34384,265265,97.95605613
5/7/2008,136690,93866,34321,264877,97.81277696
5/8/2008,136708,93713,34262,264683,97.74113737
5/9/2008,136799,93577,34276,264652,97.72968981
5/10/2008,137108,93729,34179,265016,97.86410635
5/11/2008,137273,93637,34052,264962,97.84416544
5/12/2008,137108,93440,33988,264536,97.68685377
5/13/2008,137255,93196,34003,264454,97.65657312
5/14/2008,137000,93044,34008,264052,97.50812408
5/15/2008,137054,92999,34028,264081,97.51883309
5/16/2008,137054,92892,34067,264013,97.4937223
5/17/2008,137072,92877,34179,264128,97.53618907
5/18/2008,137000,92862,34248,264110,97.5295421
5/19/2008,136908,92847,34306,264061,97.51144756
5/20/2008,136818,92953,34340,264111,97.52991137
5/21/2008,136654,93090,34345,264089,97.5217873
5/22/2008,136563,93166,34328,264057,97.50997046
5/23/2008,136399,93364,34340,264103,97.52695716
5/24/2008,136253,93212,34340,263805,97.41691285
5/25/2008,136091,93044,34379,263514,97.30945347
5/26/2008,135910,92801,34384,263095,97.15472674
5/27/2008,135693,92527,34384,262604,96.97341211
5/28/2008,135475,92283,34384,262142,96.8028065
5/29/2008,135385,92009,34404,261798,96.67577548
5/30/2008,135403,91903,34404,261710,96.64327917
5/31/2008,135385,91659,34276,261320,96.49926145
6/1/2008,135312,91416,34160,260888,96.33973412
6/2/2008,135167,91127,33983,260277,96.11410635
6/3/2008,134986,90762,33789,259537,95.84084195
6/4/2008,134714,90427,33751,258892,95.60265879
6/5/2008,134426,90093,33722,258241,95.36225997
6/6/2008,134138,89743,33708,257589,95.12149188
6/7/2008,133923,89408,33727,257058,94.9254062
6/8/2008,133563,89089,33727,256379,94.67466765
6/9/2008,133240,88876,33727,255843,94.4767356
6/10/2008,132880,88389,33717,254986,94.16026588
6/11/2008,132487,87826,33713,254026,93.80576071
6/12/2008,132093,87464,33698,253255,93.52104874
6/13/2008,131719,87016,33669,252404,93.20679468
6/14/2008,131291,86482,33625,251398,92.83530281
6/15/2008,130989,86048,33634,250671,92.566839
6/16/2008,130635,85644,33644,249923,92.29062038
6/17/2008,130528,85557,33582,249667,92.19608567
6/18/2008,130475,85470,33321,249266,92.04800591
6/19/2008,130457,85369,33038,248864,91.89955687
6/20/2008,130263,85253,32747,248263,91.67762186
6/21/2008,130032,85065,32463,247560,91.41802068
6/22/2008,129802,84877,32155,246834,91.14992614
6/23/2008,129678,84906,31892,246476,91.01772526
6/24/2008,129448,84877,31620,245945,90.82163959
6/25/2008,129077,84791,31280,245148,90.52732644
6/26/2008,128567,84704,31146,244417,90.25738552
6/27/2008,128058,84603,31127,243788,90.02511078
6/28/2008,127582,84501,30900,242983,89.72784343
6/29/2008,127041,84386,30786,242213,89.44350074
6/30/2008,126638,84313,30776,241727,89.2640325
7/1/2008,126219,84082,30739,241040,89.01033973
7/2/2008,126028,83880,30634,240542,88.82644018
7/3/2008,125505,83533,30474,239512,88.44608567
7/4/2008,125053,83200,30222,238475,88.06314623
7/5/2008,124516,82579,30000,237095,87.55354505
7/6/2008,123962,82348,29847,236157,87.20716396
7/7/2008,123445,82175,29647,235267,86.87850812
7/8/2008,122912,81727,29563,234202,86.48522895
7/9/2008,122378,81264,29527,233169,86.10376662
7/10/2008,121814,80917,29482,232213,85.75073855
7/11/2008,121300,80474,29419,231193,85.37407681
7/12/2008,120753,79700,29378,229831,84.8711226
7/13/2008,120174,79065,29333,228572,84.40620384
7/14/2008,120174,79120,29324,228618,84.42319055
7/15/2008,119818,79037,29306,228161,84.25443131
7/16/2008,119257,78816,29261,227334,83.94903988
7/17/2008,118714,78498,29204,226416,83.61004431
7/18/2008,118208,78180,29159,225547,83.28914328
7/19/2008,117702,77531,29114,224347,82.84601182
7/20/2008,117216,76965,29066,223247,82.43980798
7/21/2008,116830,76758,29057,222645,82.21750369
7/22/2008,116394,76633,29030,222057,82.00036928
7/23/2008,116043,76840,28977,221860,81.92762186
7/24/2008,121985,78360,29190,229535,84.76181684
7/25/2008,125050,80516,29919,235485,86.95901034
7/26/2008,126237,81495,29878,237610,87.7437223
7/27/2008,127093,81958,29616,238667,88.13404727
7/28/2008,128040,82406,29464,239910,88.59305761
7/29/2008,128673,82593,29186,240452,88.79320532
7/30/2008,128919,82536,29106,240561,88.83345643
7/31/2008,128884,82463,29137,240484,88.80502216
8/1/2008,128866,82319,29057,240242,88.71565731
8/2/2008,128778,82117,28955,239850,88.57090103
8/3/2008,128761,81871,28884,239516,88.44756278
8/4/2008,128673,81683,28808,239164,88.31757755
8/5/2008,128567,81394,28690,238651,88.12813885
8/6/2008,128497,81206,28641,238344,88.01477105
8/7/2008,128304,80903,28609,237816,87.81979321
8/8/2008,128128,80543,28561,237232,87.60413589
8/9/2008,127952,80129,28395,236476,87.32496307
8/10/2008,127741,79700,28377,235818,87.08197932
8/11/2008,127670,79673,28368,235711,87.04246677
8/12/2008,127565,79507,28307,235379,86.91986706
8/13/2008,127216,79258,28250,234724,86.67799114
8/14/2008,126848,79051,28180,234079,86.43980798
8/15/2008,126464,78733,28101,233298,86.15140325
8/16/2008,126149,78305,28001,232455,85.8401034
8/17/2008,125800,78070,28001,231871,85.62444609
8/18/2008,125384,77766,27979,231129,85.35044313
8/19/2008,125019,77338,27862,230219,85.01440177
8/20/2008,124690,76854,27826,229370,84.70088626
8/21/2008,124378,76343,27705,228426,84.35228951
8/22/2008,123911,75652,27356,226919,83.79579025
8/23/2008,123428,74947,27236,225611,83.31277696
8/24/2008,122912,74423,27202,224537,82.9161743
8/25/2008,122447,73887,27163,223497,82.53212703
8/26/2008,121968,73278,27018,222264,82.07680945
8/27/2008,121453,72682,26881,221016,81.61595273
8/28/2008,120958,72020,26736,219714,81.1351551
8/29/2008,120446,71384,26587,218417,80.65620384
8/30/2008,120072,70801,26465,217338,80.2577548
8/31/2008,119597,70165,26431,216193,79.83493353
9/1/2008,119155,69662,26376,215193,79.46565731
9/2/2008,118664,69344,26350,214358,79.15731167
9/3/2008,118225,68788,26270,213283,78.76033973
9/4/2008,117770,68232,26194,212196,78.35893648
9/5/2008,117350,67794,26114,211258,78.01255539
9/6/2008,117266,67728,26097,211091,77.95088626
9/7/2008,117434,67848,26257,211539,78.11632201
9/8/2008,117166,67848,26303,211317,78.03434269
9/9/2008,116763,67794,26299,210856,77.86410635
9/10/2008,116562,67649,26307,210518,77.73929099
9/11/2008,116194,67556,26265,210015,77.55354505
9/12/2008,115759,67330,26270,209359,77.31129985
9/13/2008,115376,67050,26312,208738,77.08197932
9/14/2008,115077,66936,26363,208376,76.94830133
9/15/2008,114645,66770,26409,207824,76.74446086
9/16/2008,114279,66630,26372,207281,76.54394387
9/17/2008,113865,66439,26299,206603,76.29357459
9/18/2008,113453,66286,26219,205958,76.05539143
9/19/2008,112991,66032,26144,205167,75.76329394
9/20/2008,112563,65599,26022,204184,75.40029542
9/21/2008,112086,65001,26009,203096,74.9985229
9/22/2008,111694,64644,25980,202318,74.711226
9/23/2008,111235,63969,25862,201066,74.24889217
9/24/2008,110811,63192,25800,199803,73.78249631
9/25/2008,110355,62517,25716,198588,73.3338257
9/26/2008,109965,62123,25650,197738,73.01994092
9/27/2008,109640,61893,25608,197141,72.79948301
9/28/2008,109396,61919,25629,196944,72.7267356
9/29/2008,109186,62033,25667,196886,72.70531758
9/30/2008,108943,61970,25578,196491,72.55945347
10/1/2008,108733,61779,25533,196045,72.39475628
10/2/2008,108540,61626,25525,195691,72.2640325
10/3/2008,108282,61447,25491,195220,72.0901034
10/4/2008,108024,61218,25366,194608,71.86410635
10/5/2008,107718,61040,25366,194124,71.68537666
10/6/2008,107380,60842,25362,193584,71.4859675
10/7/2008,107028,60463,25172,192663,71.14586411
10/8/2008,106676,60011,24977,191664,70.77695716
10/9/2008,106340,59499,24776,190615,70.38958641
10/10/2008,105940,58913,24580,189433,69.95310192
10/11/2008,105573,58290,24376,188239,69.51218612
10/12/2008,105193,57899,24368,187460,69.22451994
10/13/2008,104779,57496,24356,186631,68.91838996
10/14/2008,104399,56934,24157,185490,68.49704579
10/15/2008,103987,56397,23963,184347,68.07496307
10/16/2008,103657,55897,23757,183311,67.69239291
10/17/2008,103294,55262,23565,182121,67.25295421
10/18/2008,102994,54591,23350,180935,66.81499261
10/19/2008,102570,54124,23318,180012,66.47415066
10/20/2008,102163,53704,23298,179165,66.16137371
10/21/2008,101742,53144,23092,177978,65.72304284
10/22/2008,101367,52595,22882,176844,65.3042836
10/23/2008,101226,52047,22678,175951,64.97451994
10/24/2008,101258,51733,22658,175649,64.86299852
10/25/2008,101304,51756,22654,175714,64.88700148
10/26/2008,102884,52304,23641,178829,66.0372969
10/27/2008,103971,53132,24096,181199,66.91248154
10/28/2008,104859,53669,24368,182896,67.53914328
10/29/2008,106052,54463,24756,185271,68.4161743
10/30/2008,106740,55054,24969,186763,68.96713442
10/31/2008,107396,55579,25118,188093,69.45827179
11/1/2008,108040,56092,25287,189419,69.94793205
11/2/2008,109056,56886,25521,191463,70.70273264
11/3/2008,110046,57753,25716,193515,71.46048744
11/4/2008,110974,58534,25887,195395,72.15472674
11/5/2008,111906,59450,26076,197432,72.90694239
11/6/2008,112794,60231,26278,199303,73.5978582
11/7/2008,113634,60915,26515,201064,74.24815362
11/8/2008,114396,61575,26714,202685,74.84675037
11/9/2008,115077,62173,26906,204156,75.38995569
11/10/2008,115642,62708,27068,205418,75.85598227
11/11/2008,116110,63141,27193,206444,76.23485968
11/12/2008,116511,63549,27300,207360,76.57311669
11/13/2008,116863,63905,27404,208172,76.87296898
11/14/2008,117283,64237,27554,209074,77.20605613
11/15/2008,117719,64631,27723,210073,77.57496307
11/16/2008,118411,65204,28093,211708,78.17872969
11/17/2008,119019,65930,28425,213374,78.79394387
11/18/2008,119529,66465,28614,214608,79.24963072
11/19/2008,119953,66885,28800,215638,79.62998523
11/20/2008,120361,67292,28946,216599,79.98485968
11/21/2008,120770,67808,29074,217652,80.37370753
11/22/2008,121112,68232,29163,218507,80.6894387
11/23/2008,121351,68550,29252,219153,80.92799114
11/24/2008,121643,68841,29329,219813,81.17171344
11/25/2008,122087,69291,29459,220837,81.54985229
11/26/2008,122327,69596,29518,221441,81.77289513
11/27/2008,122447,70086,29620,222153,82.03581979
11/28/2008,122601,70404,29683,222688,82.23338257
11/29/2008,122688,70682,29769,223139,82.39992614
11/30/2008,122808,71093,29832,223733,82.61927622
12/1/2008,123032,71345,29932,224309,82.83197932
12/2/2008,123118,72073,30123,225314,83.20310192
12/3/2008,123050,72510,30200,225760,83.36779911
12/4/2008,122981,72841,30046,225868,83.40768095
12/5/2008,122964,73463,29851,226278,83.55908419
12/6/2008,122912,74008,29634,226554,83.66100443
12/7/2008,122722,74436,29419,226577,83.66949778
12/8/2008,122550,74837,29190,226577,83.66949778
12/9/2008,122344,75210,28955,226509,83.644387
12/10/2008,122207,75707,28747,226661,83.70051699
12/11/2008,123101,77158,29360,229619,84.79283604
12/12/2008,126010,79535,30975,236520,87.34121123
12/13/2008,129518,82912,32297,244727,90.37186115
12/14/2008,131185,84892,32691,248768,91.86410635
12/15/2008,132093,86207,32924,251224,92.77104874
12/16/2008,133024,87406,33264,253694,93.683161
12/17/2008,133815,88632,33558,256005,94.53655835
12/18/2008,134408,89743,33756,257907,95.23892171
12/19/2008,134895,90290,33886,259071,95.66875923
12/20/2008,135221,90473,33843,259537,95.84084195
12/21/2008,135294,90397,33934,259625,95.87333826
12/22/2008,135330,90123,34028,259481,95.82016248
12/23/2008,135258,89667,33824,258749,95.54985229
12/24/2008,135094,89286,33751,258131,95.32163959
12/25/2008,135982,89636,33983,259601,95.86447563
12/26/2008,136726,90640,34281,261647,96.62001477
12/27/2008,137218,91020,34233,262471,96.92429838
12/28/2008,138351,91933,34433,264717,97.75369276
12/29/2008,139895,93333,34887,268115,99.00849335
12/30/2008,140857,94368,34951,270176,99.76957164
12/31/2008,141116,95022,34868,271006,100.0760709
1/1/2009,140838,95250,34749,270837,100.0136632
1/2/2009,140579,95204,34635,270418,99.85893648
1/3/2009,140375,95143,34325,269843,99.64660266
1/4/2009,140190,95022,34379,269591,99.55354505
1/5/2009,139859,94763,34448,269070,99.36115214
1/6/2009,139509,94459,34077,268045,98.98264402
1/7/2009,139087,94139,33925,267151,98.65251108
1/8/2009,138885,93926,33761,266572,98.43870015
1/9/2009,138498,93653,33770,265921,98.19830133
1/10/2009,138003,93181,33365,264549,97.69165436
1/11/2009,137547,92770,33374,263691,97.37481536
1/12/2009,137072,92253,33360,262685,97.00332349
1/13/2009,136526,91644,33072,261242,96.4704579
1/14/2009,135982,91112,32781,259875,95.96565731
1/15/2009,135330,90488,32486,258304,95.38552437
1/16/2009,134678,89408,32150,256236,94.62186115
1/17/2009,133995,88556,31832,254383,93.93759232
1/18/2009,133365,87883,31799,253047,93.44423929
1/19/2009,132755,87219,31771,251745,92.96344165
1/20/2009,132147,86583,31443,250173,92.38293944
1/21/2009,131416,85860,31104,248380,91.72082718
1/22/2009,130741,85181,30762,246684,91.09453471
1/23/2009,129996,84501,30429,244926,90.44534712
1/24/2009,129324,83750,30095,243169,89.7965288
1/25/2009,128620,83013,30037,241670,89.24298375
1/26/2009,127899,82232,29964,240095,88.66137371
1/27/2009,127163,81423,29602,238188,87.95716396
1/28/2009,126447,80778,29279,236504,87.33530281
1/29/2009,125888,80101,28964,234953,86.76255539
1/30/2009,125227,79341,28650,233218,86.12186115
1/31/2009,124551,78678,28158,231387,85.4457164
2/1/2009,123807,77973,27705,229485,84.74335303
2/2/2009,123118,77269,27240,227627,84.05723781
2/3/2009,122429,76495,26919,225843,83.39844904
2/4/2009,121728,75707,26634,224069,82.74335303
2/5/2009,120992,74892,26541,222425,82.13626292
2/6/2009,120344,74464,26536,221344,81.73707533
2/7/2009,119851,74423,26541,220815,81.54172821
2/8/2009,119410,74492,26541,220443,81.40435746
2/9/2009,119121,74699,26566,220386,81.38330871
2/10/2009,118765,74920,26329,220014,81.24593796
2/11/2009,118495,74947,26064,219506,81.05834564
2/12/2009,118478,75583,26039,220100,81.27769572
2/13/2009,119138,77614,26186,222938,82.32570162
2/14/2009,119410,78885,26257,224552,82.92171344
2/15/2009,119571,79921,26313,225805,83.38441654
2/16/2009,119605,80695,26351,226651,83.69682422
2/17/2009,119546,81163,26367,227076,83.85376662
2/18/2009,119342,81438,26055,226835,83.76477105
2/19/2009,119291,81741,25792,226824,83.76070901
2/20/2009,119172,81987,25729,226888,83.78434269
2/21/2009,118985,82059,25741,226785,83.74630724
2/22/2009,118747,82203,25766,226716,83.72082718
2/23/2009,118545,82276,25800,226621,83.68574594
2/24/2009,118344,82290,25475,226109,83.49667651
2/25/2009,118107,82203,25458,225768,83.37075332
2/26/2009,117905,82232,25475,225612,83.31314623
2/27/2009,117719,82232,25487,225438,83.24889217
2/28/2009,118478,83157,25662,227297,83.93537666
3/1/2009,119002,84386,25837,229225,84.64734121
3/2/2009,119240,85167,25934,230341,85.05945347
3/3/2009,119393,85586,25699,230678,85.18389956
3/4/2009,119461,85904,25737,231102,85.34047267
3/5/2009,119495,86250,25766,231511,85.49150665
3/6/2009,119444,86814,25834,232092,85.70605613
3/7/2009,119546,87392,25892,232830,85.97858198
3/8/2009,120140,88450,26064,234654,86.6521418
3/9/2009,121899,90868,26697,239464,88.42836041
3/10/2009,125574,95660,27762,248996,91.94830133
3/11/2009,127934,97315,28285,253534,93.62407681
3/12/2009,129748,98072,28800,256620,94.76366322
3/13/2009,130954,97959,29114,258027,95.28323486
3/14/2009,132004,97573,29338,258915,95.61115214
3/15/2009,132791,97218,29536,259545,95.84379616
3/16/2009,133473,96864,29737,260074,96.03914328
3/17/2009,134048,96494,29964,260506,96.19867061
3/18/2009,134246,96317,30213,260776,96.29837518
3/19/2009,134498,96060,30542,261100,96.41802068
3/20/2009,134787,95883,30896,261566,96.5901034
3/21/2009,134968,95645,31150,261763,96.66285081
3/22/2009,135185,95447,31354,261986,96.74519941
3/23/2009,135348,95326,31537,262211,96.82828656
3/24/2009,135439,95098,31672,262209,96.82754801
3/25/2009,135239,95569,31803,262611,96.97599705
3/26/2009,135130,95851,31920,262901,97.08308715
3/27/2009,135058,95963,32019,263040,97.13441654
3/28/2009,134895,95819,32080,262794,97.04357459
3/29/2009,134768,95478,32269,262515,96.94054653
3/30/2009,134841,95295,32676,262812,97.05022157
3/31/2009,134895,95387,32953,263235,97.20642541
4/1/2009,134931,95523,33120,263574,97.33161004
4/2/2009,134895,95931,33297,264123,97.53434269
4/3/2009,134841,96140,33456,264437,97.65029542
4/4/2009,135167,96301,34155,265623,98.08825702
4/5/2009,135421,96285,34596,266302,98.33899557
4/6/2009,135892,96124,34670,266686,98.48079764
4/7/2009,136508,95883,34528,266919,98.566839
4/8/2009,136799,95645,34483,266927,98.56979321
4/9/2009,137310,95463,34399,267172,98.66026588
4/10/2009,137748,95219,34272,267239,98.68500739
4/11/2009,138094,95478,34135,267707,98.85782866
4/12/2009,138388,96028,34008,268424,99.1225997
4/13/2009,138535,96301,33838,268674,99.21491876
4/14/2009,138553,96237,33674,268464,99.13737075
4/15/2009,138425,95819,33664,267908,98.93205318
4/16/2009,138443,95234,33659,267336,98.72082718
4/17/2009,138535,94641,33630,266806,98.52511078
4/18/2009,138443,94094,33509,266046,98.24446086
4/19/2009,138369,94079,33587,266035,98.24039882
4/20/2009,138149,94322,33659,266130,98.27548006
4/21/2009,138168,94352,33563,266083,98.25812408
4/22/2009,138076,94626,33625,266327,98.34822747
4/23/2009,138003,94869,33611,266483,98.40583456
4/24/2009,137985,95082,33611,266678,98.47784343
4/25/2009,137930,95158,33504,266592,98.44608567
4/26/2009,137912,95234,33587,266733,98.49815362
4/27/2009,137839,95265,33664,266768,98.51107829
4/28/2009,137784,95234,33543,266561,98.43463811
4/29/2009,137675,95067,33630,266372,98.3648449
4/30/2009,137601,94976,33698,266275,98.32902511
5/1/2009,137492,94854,33669,266015,98.23301329
5/2/2009,137437,94763,33732,265932,98.20236337
5/3/2009,137383,94641,33765,265789,98.14955687
5/4/2009,137218,94459,33809,265486,98.03766617
5/5/2009,137090,94291,33853,265234,97.94460857
5/6/2009,136981,94139,33876,264996,97.85672083
5/7/2009,136890,94018,33983,264891,97.81794682
5/8/2009,136836,93896,34121,264853,97.80391433
5/9/2009,136763,93744,34281,264788,97.77991137
5/10/2009,136981,93622,34487,265090,97.89143279
5/11/2009,137181,93501,34640,265322,97.97710487
5/12/2009,137163,93577,34523,265263,97.95531758
5/13/2009,137145,93653,34389,265187,97.92725258
5/14/2009,137145,93744,34248,265137,97.90878877
5/15/2009,137364,93942,34238,265544,98.05908419
5/16/2009,137547,93911,34272,265730,98.12776957
5/17/2009,138516,94291,34887,267694,98.85302806
5/18/2009,139546,94991,35155,269692,99.59084195
5/19/2009,140301,95523,34868,270692,99.96011817
5/20/2009,140616,95980,34616,271212,100.1521418
5/21/2009,140708,96301,34301,271310,100.1883309
5/22/2009,140542,96494,34165,271201,100.1480798
5/23/2009,140412,96527,34072,271011,100.0779173
5/24/2009,140375,96607,33993,270975,100.0646233
5/25/2009,140301,96607,33944,270852,100.0192024
5/26/2009,140190,96527,33843,270560,99.91137371
5/27/2009,140320,96639,33775,270734,99.97562777
5/28/2009,140431,96881,33751,271063,100.0971196
5/29/2009,140727,97074,33794,271595,100.2935746
5/30/2009,141005,97637,34199,272841,100.7536928
5/31/2009,140950,97798,34463,273211,100.890325
6/1/2009,141042,97766,34601,273409,100.9634417
6/2/2009,141005,97589,34577,273171,100.8755539
6/3/2009,140838,97347,34483,272668,100.689808
6/4/2009,140801,97202,34384,272387,100.5860414
6/5/2009,140468,97025,34253,271746,100.3493353
6/6/2009,140394,96864,34116,271374,100.2119645
6/7/2009,140209,96736,33969,270914,100.0420975
6/8/2009,139914,96607,33809,270330,99.82644018
6/9/2009,139730,96591,33485,269806,99.63293944
6/10/2009,139748,96607,33591,269946,99.68463811
6/11/2009,139619,96591,33649,269859,99.65251108
6/12/2009,139583,96559,33761,269903,99.66875923
6/13/2009,139564,96559,33872,269995,99.70273264
6/14/2009,139804,96736,34121,270661,99.94867061
6/15/2009,139969,96913,34394,271276,100.1757755
6/16/2009,140560,96929,34744,272233,100.5291728
6/17/2009,140690,96687,34912,272289,100.5498523
6/18/2009,140765,96398,35100,272263,100.5402511
6/19/2009,140950,96269,35409,272628,100.6750369
6/20/2009,140894,95963,35214,272071,100.4693501
6/21/2009,141949,97058,35334,274341,101.3076071
6/22/2009,142304,98168,35239,275711,101.8135155
6/23/2009,141949,98217,35170,275336,101.6750369
6/24/2009,141598,97798,35110,274506,101.3685377
6/25/2009,141283,97299,35065,273647,101.0513294
6/26/2009,141061,97009,35045,273115,100.8548744
6/27/2009,140857,96848,34833,272538,100.6418021
6/28/2009,140801,96559,34577,271937,100.4198671
6/29/2009,140653,96253,34301,271207,100.1502954
6/30/2009,140301,95899,33983,270183,99.77215657
7/1/2009,140171,95676,33746,269593,99.5542836
7/2/2009,139877,95371,33543,268791,99.25812408
7/3/2009,139583,95037,33341,267961,98.95162482
7/4/2009,139363,94885,33129,267377,98.7359675
7/5/2009,139068,94748,32885,266701,98.48633678
7/6/2009,138645,94474,32723,265842,98.16912851
7/7/2009,138296,94535,32538,265369,97.99446086
7/8/2009,138094,94839,32505,265438,98.01994092
7/9/2009,137912,95158,32524,265594,98.07754801
7/10/2009,137657,95280,32538,265475,98.03360414
7/11/2009,137310,95204,32543,265057,97.87924668
7/12/2009,137200,95250,32628,265078,97.88700148
7/13/2009,137108,95387,32723,265218,97.93870015
7/14/2009,136818,95371,32767,264956,97.84194978
7/15/2009,136526,95082,32771,264379,97.6288774
7/16/2009,136181,94961,32738,263880,97.44460857
7/17/2009,136036,94900,32786,263722,97.38626292
7/18/2009,136073,95006,32890,263969,97.47747415
7/19/2009,136109,95250,32991,264350,97.61816839
7/20/2009,135928,95250,33019,264197,97.56166913
7/21/2009,135693,95189,33043,263925,97.461226
7/22/2009,135439,95082,33053,263574,97.33161004
7/23/2009,135203,94976,33014,263193,97.19091581
7/24/2009,134895,94824,33014,262733,97.02104874
7/25/2009,134642,94672,32977,262291,96.85782866
7/26/2009,134354,94565,32972,261891,96.71011817
7/27/2009,134084,94398,32981,261463,96.55206795
7/28/2009,133761,94200,32972,260933,96.35635155
7/29/2009,133329,93957,32962,260248,96.10339734
7/30/2009,133707,94687,33881,262275,96.85192024
7/31/2009,134444,95851,34523,264818,97.79098966
8/1/2009,136690,97750,35384,269824,99.63958641
8/2/2009,137930,98023,35185,271138,100.1248154
8/3/2009,139050,97782,35185,272017,100.4494092
8/4/2009,139859,97669,35100,272628,100.6750369
8/5/2009,140246,96752,34917,271915,100.411743
8/6/2009,140190,96285,34695,271170,100.1366322
8/7/2009,139877,95819,34443,270139,99.75590842
8/8/2009,139400,95326,34296,269022,99.34342688
8/9/2009,138829,94778,34145,267752,98.87444609
8/10/2009,139234,95554,34199,268987,99.33050222
8/11/2009,139271,96382,34199,269852,99.64992614
8/12/2009,138958,96414,34086,269458,99.50443131
8/13/2009,138572,96269,34121,268962,99.32127031
8/14/2009,138113,95980,34062,268155,99.0232644
8/15/2009,137565,95584,34013,267162,98.65657312
8/16/2009,137000,95128,33872,266000,98.22747415
8/17/2009,136326,94596,33727,264649,97.72858198
8/18/2009,135747,94002,33553,263302,97.23116691
8/19/2009,135221,93546,33465,262232,96.83604136
8/20/2009,134841,93242,33379,261462,96.55169867
8/21/2009,134426,92710,33288,260424,96.16838996
8/22/2009,134678,92375,33341,260394,96.15731167
8/23/2009,134895,91964,33480,260339,96.13700148
8/24/2009,134805,91690,33659,260154,96.06868538
8/25/2009,134480,91462,33490,259432,95.80206795
8/26/2009,134210,91279,33441,258930,95.61669129
8/27/2009,134012,91127,33365,258504,95.45937962
8/28/2009,133779,90975,33259,258013,95.27806499
8/29/2009,133599,90929,33177,257705,95.16432792
8/30/2009,133779,91309,33216,258304,95.38552437
8/31/2009,133653,91629,33325,258607,95.49741507
9/1/2009,133401,91538,32981,257920,95.2437223
9/2/2009,133024,91051,32829,256904,94.86853767
9/3/2009,132665,90610,32733,256008,94.53766617
9/4/2009,132379,90153,32615,255147,94.21971935
9/5/2009,132111,89712,32396,254219,93.87703102
9/6/2009,131826,89317,32377,253520,93.61890694
9/7/2009,131576,88906,32354,252836,93.36632201
9/8/2009,131291,88465,32330,252086,93.08936484
9/9/2009,130989,87999,32108,251096,92.72378139
9/10/2009,130688,87594,31915,250197,92.39180207
9/11/2009,130280,87219,31691,249190,92.01994092
9/12/2009,129925,86886,31537,248348,91.70901034
9/13/2009,129536,86539,31546,247621,91.44054653
9/14/2009,129112,86193,31537,246842,91.15288035
9/15/2009,128708,85817,31332,245857,90.78914328
9/16/2009,128251,85427,31169,244847,90.4161743
9/17/2009,127829,85340,31035,244204,90.17872969
9/18/2009,127390,85253,30905,243548,89.93648449
9/19/2009,127006,85152,30767,242925,89.70642541
9/20/2009,126499,85022,30753,242274,89.46602659
9/21/2009,126097,84892,30730,241719,89.26107829
9/22/2009,125679,84733,30566,240978,88.98744461
9/23/2009,125349,84559,30542,240450,88.79246677
9/24/2009,125036,84429,30369,239834,88.56499261
9/25/2009,124638,84241,30164,239043,88.27289513
9/26/2009,124205,84024,29959,238188,87.95716396
9/27/2009,123859,83981,29968,237808,87.816839
9/28/2009,123825,84010,30064,237899,87.85044313
9/29/2009,123583,84270,29968,237821,87.82163959
9/30/2009,123187,84270,29838,237295,87.6274003
10/1/2009,122825,84270,29665,236760,87.42983752
10/2/2009,122481,84270,29509,236260,87.24519941
10/3/2009,122121,84256,29387,235764,87.0620384
10/4/2009,121848,84256,29432,235536,86.97784343
10/5/2009,121505,84256,29455,235216,86.85967504
10/6/2009,121112,84241,29279,234632,86.64401773
10/7/2009,120735,84227,29146,234108,86.45051699
10/8/2009,120429,84140,29044,233613,86.26772526
10/9/2009,120089,84010,28920,233019,86.04837518
10/10/2009,119767,84010,28826,232603,85.89475628
10/11/2009,119444,83966,28848,232258,85.76735598
10/12/2009,119121,83807,28861,231789,85.59416544
10/13/2009,118731,83692,28716,231139,85.35413589
10/14/2009,118259,83518,28592,230369,85.06979321
10/15/2009,117804,83345,28451,229600,84.78581979
10/16/2009,117417,83302,28324,229043,84.58013294
10/17/2009,117031,83273,28263,228567,84.40435746
10/18/2009,116628,83215,28276,228119,84.23892171
10/19/2009,116211,83143,28276,227630,84.05834564
10/20/2009,115792,82984,28276,227052,83.84490399
10/21/2009,115393,82839,28049,226281,83.56019202
10/22/2009,115011,82622,27813,225446,83.25184638
10/23/2009,114611,82435,27572,224618,82.94608567
10/24/2009,114346,82463,27335,224144,82.77104874
10/25/2009,115144,84328,28381,227853,84.14069424
10/26/2009,115542,85586,28614,229742,84.83825702
10/27/2009,115726,86424,28743,230893,85.26329394
10/28/2009,115709,87060,28937,231706,85.56351551
10/29/2009,116863,89697,29715,236275,87.25073855
10/30/2009,117534,91370,30095,238999,88.25664697
10/31/2009,117821,92375,30359,240555,88.83124077
11/1/2009,118242,92953,30630,241825,89.30022157
11/2/2009,118445,93136,30854,242435,89.52548006
11/3/2009,118562,93044,31058,242664,89.61004431
11/4/2009,118596,92816,31229,242641,89.60155096
11/5/2009,118596,92512,31327,242435,89.52548006
11/6/2009,118833,92147,31429,242409,89.51587888
11/7/2009,119189,91766,31565,242520,89.55686854
11/8/2009,119478,91294,31648,242420,89.51994092
11/9/2009,119682,90792,31691,242165,89.42577548
11/10/2009,119936,90229,31738,241903,89.32902511
11/11/2009,120038,89773,31780,241591,89.21381093
11/12/2009,120208,89469,31822,241499,89.17983752
11/13/2009,120293,89165,31864,241322,89.11447563
11/14/2009,120395,89089,31915,241399,89.1429099
11/15/2009,120531,89073,32009,241613,89.22193501
11/16/2009,120701,89043,32075,241819,89.29800591
11/17/2009,120821,88784,31882,241487,89.1754062
11/18/2009,120941,88389,31555,240885,88.95310192
11/19/2009,121095,87999,31150,240244,88.71639586
11/20/2009,121368,87797,30961,240126,88.67282127
11/21/2009,121916,87826,31003,240745,88.90140325
11/22/2009,122224,87652,30802,240678,88.87666174
11/23/2009,122464,87450,30538,240452,88.79320532
11/24/2009,122705,87204,30255,240164,88.68685377
11/25/2009,122877,86929,29964,239770,88.54135894
11/26/2009,123015,86756,29878,239649,88.49667651
11/27/2009,123273,86496,29792,239561,88.46418021
11/28/2009,123514,86221,29869,239604,88.48005908
11/29/2009,123739,86091,29950,239780,88.5450517
11/30/2009,123979,85831,30037,239847,88.56979321
12/1/2009,124308,85571,30137,240016,88.63220089
12/2/2009,124378,85369,30168,239915,88.59490399
12/3/2009,124846,85268,30433,240547,88.82828656
12/4/2009,126044,85745,31336,243125,89.78028065
12/5/2009,126778,86135,31648,244561,90.3105613
12/6/2009,127390,86496,31868,245754,90.75110783
12/7/2009,127882,86799,32023,246704,91.10192024
12/8/2009,128304,87002,32150,247456,91.37961595
12/9/2009,128778,87262,32302,248342,91.70679468
12/10/2009,129148,87378,32434,248960,91.93500739
12/11/2009,129483,87666,32557,249706,92.21048744
12/12/2009,129748,87854,32652,250254,92.41285081
12/13/2009,129925,88057,32723,250705,92.57939439
12/14/2009,130528,88541,32938,252007,93.06019202
12/15/2009,131025,88861,33101,252987,93.42208272
12/16/2009,131630,89119,33245,253994,93.79394387
12/17/2009,131791,89651,33014,254456,93.96454948
12/18/2009,132165,89925,32662,254752,94.07385524
12/19/2009,132434,90077,32274,254785,94.08604136
12/20/2009,132487,90062,31892,254441,93.95901034
12/21/2009,132541,89895,31461,253897,93.75812408
12/22/2009,132272,89469,31215,252956,93.41063516
12/23/2009,131773,88769,30947,251489,92.86890694
12/24/2009,131309,87941,30684,249934,92.29468242
12/25/2009,130866,87103,30542,248511,91.76920236
12/26/2009,130440,86366,30410,247216,91.29098966
12/27/2009,130263,85875,30465,246603,91.06462334
12/28/2009,130369,85774,30730,246873,91.16432792
12/29/2009,130245,85499,30910,246654,91.08345643
12/30/2009,129908,85282,31003,246193,90.91322009
12/31/2009,129660,85326,31113,246099,90.87850812
1/1/2010,129448,85427,31220,246095,90.87703102
1/2/2010,129165,85513,31261,245939,90.81942393
1/3/2010,128796,85456,31275,245527,90.66728213
1/4/2010,128479,85282,31261,245022,90.48079764
1/5/2010,128093,85138,31252,244483,90.28175775
1/6/2010,127846,85210,31220,244276,90.20531758
1/7/2010,127688,85282,31183,244153,90.1598966
1/8/2010,127582,85311,31165,244058,90.12481536
1/9/2010,127355,85123,31183,243661,89.9782127
1/10/2010,127146,84704,31188,243038,89.74815362
1/11/2010,126883,84024,31193,242100,89.40177253
1/12/2010,126691,83302,31202,241195,89.06757755
1/13/2010,126394,82651,31215,240260,88.72230428
1/14/2010,126342,81972,31215,239529,88.45236337
1/15/2010,126394,81235,31215,238844,88.19940916
1/16/2010,126412,80861,31215,238488,88.06794682
1/17/2010,126464,80170,31202,237836,87.82717873
1/18/2010,126603,79562,31239,237404,87.6676514
1/19/2010,126708,79617,31243,237568,87.7282127
1/20/2010,126691,79755,31257,237703,87.77806499
1/21/2010,126761,79908,31252,237921,87.85856721
1/22/2010,126778,79963,31243,237984,87.88183161
1/23/2010,126726,79769,31188,237683,87.77067947
1/24/2010,126447,79231,31118,236796,87.44313146
1/25/2010,126377,78788,31099,236264,87.24667651
1/26/2010,131809,83778,33465,249052,91.9689808
1/27/2010,134084,86915,33939,254938,94.14254062
1/28/2010,135239,88013,33713,256965,94.89106352
1/29/2010,135910,88252,33369,257531,95.10007386
1/30/2010,136272,88057,33158,257487,95.0838257
1/31/2010,136472,87551,32790,256813,94.83493353
2/1/2010,136654,86828,32405,255887,94.49298375
2/2/2010,136708,86467,31929,255104,94.20384047
2/3/2010,136654,86539,31653,254846,94.10856721
2/4/2010,136581,86496,31174,254251,93.88884786
2/5/2010,136181,86554,30859,253594,93.64623338
2/6/2010,135656,86727,30630,253013,93.4316839
2/7/2010,135058,86814,30359,252231,93.1429099
2/8/2010,134444,86843,30086,251373,92.8260709
2/9/2010,133869,86886,29819,250574,92.5310192
2/10/2010,133240,86915,29647,249802,92.24593796
2/11/2010,132594,86958,29518,249070,91.97562777
2/12/2010,132004,86958,29342,248304,91.69276219
2/13/2010,131309,86828,29186,247323,91.33050222
2/14/2010,130635,86785,29222,246642,91.07902511
2/15/2010,129925,86727,29261,245913,90.80982275
2/16/2010,129236,86482,29101,244819,90.40583456
2/17/2010,128602,86193,29021,243816,90.03545052
2/18/2010,128005,85933,28920,242858,89.6816839
2/19/2010,127565,85644,28835,242044,89.38109306
2/20/2010,127181,85427,28663,241271,89.09564254
2/21/2010,126813,85326,28681,240820,88.92909897
2/22/2010,126412,85224,28694,240330,88.74815362
2/23/2010,126010,84979,28517,239506,88.44387001
2/24/2010,125888,84776,28486,239150,88.31240768
2/25/2010,125905,84617,28482,239004,88.25849335
2/26/2010,125870,84299,28552,238721,88.15398818
2/27/2010,125279,83648,28530,237457,87.68722304
2/28/2010,124585,82912,28486,235983,87.1429099
3/1/2010,123859,82146,28434,234439,86.57274742
3/2/2010,123118,81394,28390,232902,86.00516987
3/3/2010,122429,80585,28324,231338,85.42762186
3/4/2010,121694,79825,28263,229782,84.85302806
3/5/2010,121129,79051,28254,228434,84.35524372
3/6/2010,120514,78305,28258,227077,83.85413589
3/7/2010,119936,77517,28250,225703,83.34675037
3/8/2010,119359,76771,28250,224380,82.85819793
3/9/2010,118799,76081,28267,223147,82.40288035
3/10/2010,118377,75486,28311,222174,82.04357459
3/11/2010,118141,74989,28342,221472,81.78434269
3/12/2010,118512,75113,28411,222036,81.99261448
3/13/2010,119376,76067,28478,223921,82.68870015
3/14/2010,121626,77255,29151,228032,84.20679468
3/15/2010,124777,79396,29874,234047,86.42799114
3/16/2010,127006,81134,30128,238268,87.98670606
3/17/2010,128602,82695,30227,241524,89.18906942
3/18/2010,129996,84140,30465,244601,90.32533235
3/19/2010,131434,85456,30712,247602,91.43353028
3/20/2010,132970,86828,31215,251013,92.69313146
3/21/2010,134750,88206,31818,254774,94.08197932
3/22/2010,136690,89712,32449,258851,95.58751846
3/23/2010,141709,92542,34927,269178,99.40103397
3/24/2010,143667,97782,35414,276863,102.2389217
3/25/2010,142976,99199,35249,277424,102.4460857
3/26/2010,142528,99359,35219,277106,102.3286558
3/27/2010,142192,99118,35175,276485,102.0993353
3/28/2010,141839,98571,35120,275530,101.7466765
3/29/2010,141857,98152,35324,275333,101.6739291
3/30/2010,141783,97878,35344,275005,101.5528065
3/31/2010,142826,98603,35523,276952,102.2717873
4/1/2010,142696,99022,35309,277027,102.299483
4/2/2010,142378,98700,35249,276327,102.0409897
4/3/2010,142192,98233,35254,275679,101.8016987
4/4/2010,142080,97798,35244,275122,101.5960118
4/5/2010,141839,97363,35204,274406,101.33161
4/6/2010,141357,96961,35180,273498,100.9963072
4/7/2010,140950,96591,35090,272631,100.6761448
4/8/2010,140653,96237,34907,271797,100.3681684
4/9/2010,140523,95963,34793,271279,100.1768833
4/10/2010,140375,95754,34684,270813,100.0048006
4/11/2010,140079,95463,34458,270000,99.70457903
4/12/2010,139859,95204,34209,269272,99.43574594
4/13/2010,139656,95052,34116,268824,99.27031019
4/14/2010,139528,94915,34028,268471,99.13995569
4/15/2010,139400,94793,33920,268113,99.0077548
4/16/2010,139271,94657,33819,267747,98.8725997
4/17/2010,139234,94672,33688,267594,98.81610044
4/18/2010,139160,94946,33804,267910,98.93279173
4/19/2010,139013,95234,33896,268143,99.01883309
4/20/2010,138848,95371,33727,267946,98.94608567
4/21/2010,138645,95371,33649,267665,98.84231905
4/22/2010,138443,95341,33553,267337,98.72119645
4/23/2010,138205,95265,33499,266969,98.58530281
4/24/2010,137966,95189,33456,266611,98.45310192
4/25/2010,137875,95128,33523,266526,98.42171344
4/26/2010,138003,95189,33644,266836,98.53618907
4/27/2010,138277,95539,33649,267465,98.76846381
4/28/2010,138351,95915,33644,267910,98.93279173
4/29/2010,138480,96189,33630,268299,99.07644018
4/30/2010,138609,96285,33606,268500,99.1506647
5/1/2010,138737,96301,33591,268629,99.19830133
5/2/2010,138811,96205,33630,268646,99.20457903
5/3/2010,138848,96092,33674,268614,99.19276219
5/4/2010,138866,96060,33722,268648,99.20531758
5/5/2010,138903,95980,33741,268624,99.19645495
5/6/2010,138866,95850,33751,268467,99.13847858
5/7/2010,138774,95754,33765,268293,99.07422452
5/8/2010,138737,95819,33794,268350,99.09527326
5/9/2010,138793,96012,33862,268667,99.21233383
5/10/2010,138682,96044,33876,268602,99.18833087
5/11/2010,138553,95996,33886,268435,99.12666174
5/12/2010,138461,96028,33939,268428,99.12407681
5/13/2010,138645,96108,33983,268736,99.23781388
5/14/2010,138976,96173,34037,269186,99.40398818
5/15/2010,139381,96301,34077,269759,99.61558346
5/16/2010,139363,96301,34106,269770,99.61964549
5/17/2010,139345,96269,34126,269740,99.60856721
5/18/2010,139308,96189,34150,269647,99.57422452
5/19/2010,139308,96124,34224,269656,99.57754801
5/20/2010,139400,96076,34238,269714,99.59896603
5/21/2010,139638,96012,34272,269922,99.67577548
5/22/2010,139638,95835,34281,269754,99.61373708
5/23/2010,139619,95645,34311,269575,99.54763663
5/24/2010,139583,95463,34325,269371,99.47230428
5/25/2010,139509,95250,34325,269084,99.36632201
5/26/2010,139363,95006,34330,268699,99.22415066
5/27/2010,139326,94763,34316,268405,99.11558346
5/28/2010,139271,94504,34409,268184,99.03397341
5/29/2010,138995,94231,34443,267669,98.84379616
5/30/2010,138737,93942,34443,267122,98.64180207
5/31/2010,138443,93622,34453,266518,98.41875923
6/1/2010,138131,93348,34443,265922,98.19867061
6/2/2010,137966,93257,34453,265676,98.10782866
6/3/2010,137748,93196,34409,265353,97.98855244
6/4/2010,137528,93105,34374,265007,97.86078287
6/5/2010,137145,92968,34355,264468,97.66174298
6/6/2010,136799,92786,34350,263935,97.46491876
6/7/2010,136581,92649,34365,263595,97.33936484
6/8/2010,136145,92497,34345,262987,97.1148449
6/9/2010,135765,92223,34330,262318,96.86779911
6/10/2010,135475,92116,34384,261975,96.74113737
6/11/2010,135167,91933,34419,261519,96.57274742
6/12/2010,134750,91675,34224,260649,96.2514771
6/13/2010,134660,91492,34267,260419,96.16654357
6/14/2010,134462,91340,34365,260167,96.07348597
6/15/2010,134084,91127,34214,259425,95.79948301
6/16/2010,133689,90823,34032,258544,95.47415066
6/17/2010,133365,90549,33838,257752,95.1816839
6/18/2010,133024,90290,33843,257157,94.96196455
6/19/2010,132629,89956,33843,256428,94.69276219
6/20/2010,132237,89636,33838,255711,94.42799114
6/21/2010,131809,89286,33819,254914,94.13367799
6/22/2010,131416,88906,33799,254121,93.84084195
6/23/2010,131043,88541,33804,253388,93.57016248
6/24/2010,130652,88161,33813,252626,93.288774
6/25/2010,130369,87826,33784,251979,93.04985229
6/26/2010,129908,87450,33761,251119,92.73227474
6/27/2010,129448,87089,33736,250273,92.41986706
6/28/2010,129007,86698,33708,249413,92.10228951
6/29/2010,128585,86381,33684,248650,91.82053176
6/30/2010,128163,85990,33634,247787,91.50184638
7/1/2010,127670,85644,33273,246587,91.05871492
7/2/2010,127198,85224,33062,245484,90.65140325
7/3/2010,126708,84632,32895,244235,90.19017725
7/4/2010,126237,84183,32857,243277,89.83641064
7/5/2010,125714,83807,32815,242336,89.48892171
7/6/2010,125227,83388,32767,241382,89.1366322
7/7/2010,124725,82912,32610,240247,88.71750369
7/8/2010,124239,82406,32481,239126,88.30354505
7/9/2010,123842,81943,32344,238129,87.93537666
7/10/2010,123549,81611,32213,237373,87.65620384
7/11/2010,123428,81308,32127,236863,87.46787297
7/12/2010,123032,81018,32090,236140,87.20088626
7/13/2010,122601,80682,31948,235231,86.86521418
7/14/2010,122173,80336,31841,234350,86.53988183
7/15/2010,121814,79991,31719,233524,86.23485968
7/16/2010,121351,79590,31592,232533,85.86890694
7/17/2010,120992,79134,31447,231573,85.51440177
7/18/2010,120514,78650,31397,230561,85.14069424
7/19/2010,120157,78249,31341,229747,84.8401034
7/20/2010,119699,77890,31206,228795,84.48855244
7/21/2010,119240,77476,31017,227733,84.09638109
7/22/2010,118985,77144,30873,227002,83.82644018
7/23/2010,118596,76785,30693,226074,83.48375185
7/24/2010,118478,76633,30561,225672,83.33530281
7/25/2010,118242,76481,30529,225252,83.18020679
7/26/2010,117972,76219,30487,224678,82.96824225
7/27/2010,117619,75915,30314,223848,82.66174298
7/28/2010,117232,75542,30164,222938,82.32570162
7/29/2010,116796,75196,29973,221965,81.96639586
7/30/2010,116428,74796,29769,220993,81.60745938
7/31/2010,116009,74216,29571,219796,81.16543575
8/1/2010,115608,73569,29513,218690,80.75701625
8/2/2010,115177,72907,29468,217552,80.33677991
8/3/2010,114812,72364,29405,216581,79.9782127
8/4/2010,114396,71596,29356,215348,79.52289513
8/5/2010,114014,70775,29306,214095,79.06019202
8/6/2010,113716,70086,29270,213072,78.68242245
8/7/2010,113272,69278,29213,211763,78.19903988
8/8/2010,112826,68378,29155,210359,77.68057607
8/9/2010,112365,67384,29088,208837,77.11853767
8/10/2010,111906,66439,28637,206982,76.43353028
8/11/2010,110398,65434,28189,204021,75.3401034
8/12/2010,110892,64415,27822,203129,75.01070901
8/13/2010,110533,63434,27503,201470,74.39807976
8/14/2010,110208,62454,27150,199812,73.78581979
8/15/2010,109867,61384,26799,198050,73.1351551
8/16/2010,109543,60414,26545,196502,72.56351551
8/17/2010,109234,59462,26380,195076,72.03692762
8/18/2010,108846,58522,26190,193558,71.47636632
8/19/2010,108540,57692,26013,192245,70.99150665
8/20/2010,108088,56947,25821,190856,70.47858198
8/21/2010,107605,56165,25633,189403,69.94202363
8/22/2010,107188,55396,25578,188162,69.48375185
8/23/2010,107172,55188,25708,188068,69.44903988
8/24/2010,106996,55860,25821,188677,69.6739291
8/25/2010,106740,56055,25741,188536,69.62186115
8/26/2010,106420,56214,25612,188246,69.51477105
8/27/2010,106052,56239,25616,187907,69.38958641
8/28/2010,105637,56190,25595,187422,69.21048744
8/29/2010,105241,56104,25549,186894,69.0155096
8/30/2010,104795,56092,25512,186399,68.83271787
8/31/2010,104351,55750,25466,185567,68.52548006
9/1/2010,103893,55347,25420,184660,68.19054653
9/2/2010,103468,54883,25366,183717,67.84231905
9/3/2010,102979,54288,25313,182580,67.42245199
9/4/2010,102492,53447,25262,181201,66.91322009
9/5/2010,102039,52572,25205,179816,66.40177253
9/6/2010,101586,51791,25142,178519,65.92282127
9/7/2010,101086,51138,25089,177313,65.47747415
9/8/2010,100590,50426,25039,176055,65.01292467
9/9/2010,100078,49725,24981,174784,64.54357459
9/10/2010,99629,48959,24916,173504,64.07090103
9/11/2010,99151,48070,24863,172084,63.5465288
9/12/2010,98644,47169,24805,170618,63.00516987
9/13/2010,98198,46368,24764,169330,62.5295421
9/14/2010,98168,45523,24711,168402,62.18685377
9/15/2010,97786,44734,24658,167178,61.73485968
9/16/2010,97313,44100,24596,166009,61.30317578
9/17/2010,96856,43477,24568,164901,60.89401773
9/18/2010,96400,42941,24246,163587,60.40878877
9/19/2010,95978,42342,24209,162529,60.01809453
9/20/2010,95523,41837,24173,161533,59.65029542
9/21/2010,95071,41281,23842,160194,59.15583456
9/22/2010,94590,40703,23653,158946,58.69497784
9/23/2010,94126,39999,23465,157590,58.19423929
9/24/2010,93692,39306,23286,156284,57.71196455
9/25/2010,93229,38559,22913,154701,57.1274003
9/26/2010,92799,37787,22882,153468,56.67208272
9/27/2010,92323,37381,22839,152543,56.33050222
9/28/2010,91924,37272,22564,151760,56.04135894
9/29/2010,91688,37153,22513,151354,55.89143279
9/30/2010,91364,37093,22412,150869,55.71233383
10/1/2010,97511,39789,25345,162645,60.06093058
10/2/2010,104827,49049,27632,181508,67.02658789
10/3/2010,106868,52490,28036,187394,69.20014771
10/4/2010,108024,54112,28241,190377,70.30169867
10/5/2010,109186,55872,28460,193518,71.46159527
10/6/2010,109835,57960,28707,196502,72.56351551
10/7/2010,110176,59462,28906,198544,73.31757755
10/8/2010,110404,60817,29057,200278,73.95790251
10/9/2010,110631,61855,29168,201654,74.46602659
10/10/2010,110762,62683,29270,202715,74.85782866
10/11/2010,110647,63358,29356,203361,75.09638109
10/12/2010,110551,63969,29414,203934,75.30797637
10/13/2010,110420,64326,29468,204214,75.41137371
10/14/2010,110306,64848,29518,204672,75.58050222
10/15/2010,110241,65255,29584,205080,75.73116691
10/16/2010,110941,66134,29563,206638,76.30649926
10/17/2010,111595,67190,29495,208280,76.91285081
10/18/2010,112021,67901,29329,209251,77.27141802
10/19/2010,112316,68351,29231,209898,77.51033973
10/20/2010,112662,68749,29119,210530,77.7437223
10/21/2010,112679,69027,28747,210453,77.71528804
10/22/2010,112695,69225,28333,210253,77.64143279
10/23/2010,112646,69411,27905,209962,77.53397341
10/24/2010,112547,69543,27477,209567,77.38810931
10/25/2010,112431,69596,27052,209079,77.20790251
10/26/2010,112778,69966,27129,209873,77.50110783
10/27/2010,113206,70642,27300,211148,77.97193501
10/28/2010,113981,71649,27745,213375,78.79431315
10/29/2010,114230,72165,27813,214208,79.10192024
10/30/2010,114313,72496,27606,214415,79.17836041
10/31/2010,114363,72788,27339,214490,79.20605613
11/1/2010,114346,72987,27056,214389,79.16875923
11/2/2010,114761,73410,27124,215295,79.50332349
11/3/2010,115061,73795,27202,216058,79.78508124
11/4/2010,115028,73927,27279,216234,79.85007386
11/5/2010,115343,74257,27507,217107,80.17245199
11/6/2010,115492,74685,27658,217835,80.44128508
11/7/2010,115492,74947,27775,218214,80.58124077
11/8/2010,115426,75155,27875,218456,80.67060561
11/9/2010,115559,75362,27962,218883,80.82828656
11/10/2010,115709,75542,28058,219309,80.98559823
11/11/2010,115842,75859,28167,219868,81.19202363
11/12/2010,115893,76081,28276,220250,81.33308715
11/13/2010,115909,76233,28359,220501,81.42577548
11/14/2010,115893,76357,28447,220697,81.49815362
11/15/2010,115859,76440,28522,220821,81.54394387
11/16/2010,115826,76509,28601,220936,81.58641064
11/17/2010,115893,76675,28694,221262,81.70679468
11/18/2010,116411,77269,29035,222715,82.24335303
11/19/2010,116679,77918,29195,223792,82.64106352
11/20/2010,116863,78553,29333,224749,82.99446086
11/21/2010,117014,79092,29441,225547,83.28914328
11/22/2010,117064,79603,29580,226247,83.54763663
11/23/2010,117132,80060,29688,226880,83.78138848
11/24/2010,117064,80474,29288,226826,83.76144756
11/25/2010,116981,80709,29163,226853,83.77141802
11/26/2010,117014,81076,29279,227369,83.96196455
11/27/2010,117166,81683,29351,228200,84.26883309
11/28/2010,117199,82088,29450,228737,84.46713442
11/29/2010,117216,82435,29554,229205,84.63995569
11/30/2010,117149,82753,29495,229397,84.71085672
12/1/2010,117568,83215,29647,230430,85.09231905
12/2/2010,121282,85484,32643,239409,88.40805022
12/3/2010,123204,87291,33273,243768,90.01772526
12/4/2010,124533,88556,33514,246603,91.06462334
12/5/2010,125574,89545,33684,248803,91.87703102
12/6/2010,126429,90351,33824,250604,92.54209749
12/7/2010,127075,91036,33901,252012,93.0620384
12/8/2010,127250,91462,33703,252415,93.21085672
12/9/2010,127250,91583,33341,252174,93.12186115
12/10/2010,127181,91127,32972,251280,92.79172821
12/11/2010,127111,90412,32800,250323,92.43833087
12/12/2010,127006,89758,32628,249392,92.09453471
12/13/2010,127512,89712,32819,250043,92.33493353
12/14/2010,127987,90016,32929,250932,92.66322009
12/15/2010,128233,89971,32871,251075,92.71602659
12/16/2010,128339,89834,32848,251021,92.69608567
12/17/2010,128479,89727,32776,250982,92.6816839
12/18/2010,128497,89545,32676,250718,92.58419498
12/19/2010,128462,89165,32567,250194,92.39069424
12/20/2010,128304,88739,32386,249429,92.10819793
12/21/2010,128198,88237,32326,248761,91.86152142
12/22/2010,128093,87768,32184,248045,91.59711965
12/23/2010,127882,87233,32042,247157,91.26920236
12/24/2010,127706,86684,31887,246277,90.94423929
12/25/2010,127425,86106,31728,245259,90.5683161
12/26/2010,127181,85600,31569,244350,90.23264402
12/27/2010,126936,85268,31406,243610,89.95937962
12/28/2010,126621,85152,31202,242975,89.72488922
12/29/2010,126377,84979,30864,242220,89.44608567
12/30/2010,125974,84762,30510,241246,89.08641064
12/31/2010,125609,84516,30132,240257,88.72119645
1/1/2011,125278,84270,29778,239326,88.3774003
1/2/2011,125122,84183,29455,238760,88.16838996
1/3/2011,125105,84342,29159,238606,88.11152142
1/4/2011,124950,84328,28999,238277,87.99002954
1/5/2011,124794,84169,28852,237815,87.81942393
1/6/2011,124515,84039,28668,237222,87.60044313
1/7/2011,124395,84039,28672,237106,87.55760709
1/8/2011,124274,84024,28712,237010,87.52215657
1/9/2011,124135,83981,28756,236872,87.47119645
1/10/2011,123911,83909,28773,236593,87.36816839
1/11/2011,123739,83807,28791,236337,87.27363368
1/12/2011,123600,83750,28852,236202,87.22378139
1/13/2011,123480,83634,28884,235998,87.14844904
1/14/2011,123204,83504,28870,235578,86.99335303
1/15/2011,122912,83273,28884,235069,86.80539143
1/16/2011,122670,82969,28902,234541,86.61041359
1/17/2011,122429,82724,28924,234077,86.43906942
1/18/2011,122173,82435,28955,233563,86.24926145
1/19/2011,122156,82305,29012,233473,86.21602659
1/20/2011,121951,82263,29426,233640,86.27769572
1/21/2011,121814,82088,29128,233030,86.05243722
1/22/2011,121609,81871,29151,232631,85.90509601
1/23/2011,121300,81582,29155,232037,85.68574594
1/24/2011,121009,81293,29172,231474,85.47784343
1/25/2011,120735,81004,29186,230925,85.27511078
1/26/2011,120412,80806,29190,230408,85.08419498
1/27/2011,120089,80585,29190,229864,84.88330871
1/28/2011,119784,80378,29195,229357,84.69608567
1/29/2011,119478,80115,29204,228797,84.48929099
1/30/2011,119189,79866,29213,228268,84.29394387
1/31/2011,118867,79576,29231,227674,84.0745938
2/1/2011,118596,79300,29248,227144,83.8788774
2/2/2011,118411,79106,29284,226801,83.75221566
2/3/2011,118158,78830,29306,226294,83.56499261
2/4/2011,117770,78553,29297,225620,83.31610044
2/5/2011,117451,78194,29288,224933,83.06240768
2/6/2011,117283,78014,29311,224608,82.94239291
2/7/2011,117081,77945,29347,224373,82.855613
2/8/2011,116897,77807,29351,224055,82.73818316
2/9/2011,116796,77628,29151,223575,82.56093058
2/10/2011,116528,77379,28933,222840,82.28951256
2/11/2011,116177,77131,28716,222024,81.98818316
2/12/2011,115826,76840,28486,221152,81.6661743
2/13/2011,115459,76620,28473,220552,81.44460857
2/14/2011,115144,76357,28455,219956,81.22451994
2/15/2011,114845,76177,28442,219464,81.04283604
2/16/2011,114479,75984,28429,218892,80.83161004
2/17/2011,114147,75804,28403,218354,80.63293944
2/18/2011,113964,75611,28416,217991,80.49889217
2/19/2011,114213,75984,28522,218719,80.76772526
2/20/2011,114396,76606,28592,219594,81.09084195
2/21/2011,114562,77020,28632,220214,81.31979321
2/22/2011,114661,77310,28637,220608,81.46528804
2/23/2011,114678,77531,28685,220894,81.57090103
2/24/2011,114628,77628,28725,220981,81.60302806
2/25/2011,114645,78042,28786,221473,81.78471196
2/26/2011,115260,78498,28959,222717,82.24409158
2/27/2011,115692,78899,29074,223665,82.59416544
2/28/2011,116177,79300,29159,224636,82.95273264
3/1/2011,116663,80074,29172,225909,83.42282127
3/2/2011,116646,80626,28985,226257,83.55132939
3/3/2011,116730,81134,28751,226615,83.68353028
3/4/2011,116746,81365,28522,226633,83.69017725
3/5/2011,116763,81047,28311,226121,83.50110783
3/6/2011,117451,81235,28127,226813,83.75664697
3/7/2011,123653,86944,30538,241135,89.04542097
3/8/2011,126866,90260,31466,248592,91.79911374
3/9/2011,128462,91827,31798,252087,93.08973412
3/10/2011,129642,92710,32023,254375,93.93463811
3/11/2011,133797,96639,34023,264459,97.6584195
3/12/2011,139785,102096,35399,277280,102.3929099
3/13/2011,141691,101967,35244,278902,102.9918759
3/14/2011,142005,101130,35170,278305,102.771418
3/15/2011,141949,100277,35125,277351,102.4191285
3/16/2011,141635,99343,35095,276073,101.9471935
3/17/2011,141412,98619,35150,275181,101.6177991
3/18/2011,141338,98345,35115,274798,101.4763663
3/19/2011,141746,98732,35244,275722,101.8175775
3/20/2011,141949,98812,35140,275901,101.883678
3/21/2011,141857,98523,35075,275455,101.7189808
3/22/2011,141617,98168,35006,274791,101.4737814
3/23/2011,141338,97846,34833,274017,101.1879616
3/24/2011,140987,97524,34577,273088,100.844904
3/25/2011,140653,97154,34414,272221,100.5247415
3/26/2011,140357,96784,34199,271340,100.1994092
3/27/2011,140061,96430,34072,270563,99.91248154
3/28/2011,139675,96028,33925,269628,99.56720827
3/29/2011,139326,95676,33761,268763,99.24778434
3/30/2011,138866,95311,33601,267778,98.88404727
3/31/2011,138443,94915,33427,266785,98.51735598
4/1/2011,138003,94504,33321,265828,98.16395864
4/2/2011,137583,94155,33249,264987,97.85339734
4/3/2011,137127,93759,33177,264063,97.51218612
4/4/2011,136636,93409,33091,263136,97.16986706
4/5/2011,136472,93561,33081,263114,97.16174298
4/6/2011,136908,95128,33398,265434,98.01846381
4/7/2011,137310,96092,33616,267018,98.60339734
4/8/2011,137455,96511,33813,267779,98.88441654
4/9/2011,137510,96591,33625,267726,98.8648449
4/10/2011,137455,96639,33451,267545,98.79800591
4/11/2011,137638,96655,33283,267576,98.80945347
4/12/2011,138737,96704,33577,269018,99.34194978
4/13/2011,139418,96816,34067,270301,99.81573117
4/14/2011,140006,96961,34513,271480,100.2511078
4/15/2011,140375,96848,34577,271800,100.3692762
4/16/2011,140542,96494,34423,271459,100.243353
4/17/2011,141079,96607,34848,272534,100.640325
4/18/2011,141431,97009,35085,273525,101.0062777
4/19/2011,141357,96993,34981,273331,100.9346381
4/20/2011,141412,97009,34936,273357,100.9442393
4/21/2011,141283,96929,34823,273035,100.8253323
4/22/2011,141153,96736,34665,272554,100.6477105
4/23/2011,141116,96575,34513,272204,100.5184638
4/24/2011,141283,96832,34635,272750,100.7200886
4/25/2011,141264,96816,34631,272711,100.7056869
4/26/2011,141357,97138,34675,273170,100.8751846
4/27/2011,141727,97959,34754,274440,101.3441654
4/28/2011,142136,98732,35135,276003,101.9213442
4/29/2011,142640,101307,35389,279336,103.1521418
4/30/2011,142322,101097,35209,278628,102.8906942
5/1/2011,142005,100373,35150,277528,102.4844904
5/2/2011,141691,99665,35145,276501,102.1052437
5/3/2011,141561,99118,35135,275814,101.851551
5/4/2011,141746,99150,35055,275951,101.9021418
5/5/2011,142005,99842,34996,276843,102.2315362
5/6/2011,141709,99665,34823,276197,101.9929838
5/7/2011,141431,99311,34650,275392,101.6957164
5/8/2011,141172,98989,34538,274699,101.439808
5/9/2011,140950,98651,34409,274010,101.1853767
5/10/2011,140765,98329,34248,273342,100.9387001
5/11/2011,140597,98056,34067,272720,100.7090103
5/12/2011,140468,97814,33949,272231,100.5284343
5/13/2011,140320,97379,33934,271633,100.3076071
5/14/2011,140209,97041,33824,271074,100.1011817
5/15/2011,140171,96832,33910,270913,100.0417282
5/16/2011,140079,96816,34032,270927,100.0468981
5/17/2011,140171,97138,34111,271420,100.2289513
5/18/2011,140579,97379,34350,272308,100.5568685
5/19/2011,141209,97621,35334,274164,101.2422452
5/20/2011,141617,98233,35329,275179,101.6170606
5/21/2011,141764,99295,35229,276288,102.0265879
5/22/2011,141691,99343,35170,276204,101.9955687
5/23/2011,141543,99022,35155,275720,101.816839
5/24/2011,141524,98716,35006,275246,101.6418021
5/25/2011,141264,98378,34858,274500,101.366322
5/26/2011,140968,98088,34739,273795,101.1059823
5/27/2011,141042,97895,34695,273632,101.0457903
5/28/2011,140968,97814,34655,273437,100.9737814
5/29/2011,140708,97621,34582,272911,100.7795421
5/30/2011,140708,97669,34538,272915,100.7810192
5/31/2011,140653,97573,34670,272896,100.774003
6/1/2011,140486,97379,34660,272525,100.6370015
6/2/2011,140227,96993,34542,271762,100.3552437
6/3/2011,140116,96704,34409,271229,100.1584195
6/4/2011,139895,96205,34443,270543,99.90509601
6/5/2011,139656,95851,34523,270030,99.71565731
6/6/2011,139418,95508,34582,269508,99.52289513
6/7/2011,139142,95158,34640,268940,99.31314623
6/8/2011,138811,94687,34684,268182,99.03323486
6/9/2011,138498,94276,34695,267469,98.76994092
6/10/2011,138314,93911,34739,266964,98.58345643
6/11/2011,137966,93531,34793,266290,98.33456425
6/12/2011,137802,93333,34774,265909,98.19387001
6/13/2011,137583,93227,34730,265540,98.05760709
6/14/2011,137419,93212,34582,265213,97.93685377
6/15/2011,137273,93166,34419,264858,97.80576071
6/16/2011,137108,92847,34262,264217,97.56905465
6/17/2011,136981,92497,34267,263745,97.39475628
6/18/2011,137054,92192,34330,263576,97.3323486
6/19/2011,136927,91888,34370,263185,97.1879616
6/20/2011,136745,91538,34379,262662,96.99483013
6/21/2011,136544,91081,34379,262004,96.75184638
6/22/2011,136308,90564,34389,261261,96.47747415
6/23/2011,136036,90214,34572,260822,96.31536189
6/24/2011,136272,90351,34616,261239,96.46935007
6/25/2011,136745,90442,35254,262441,96.91322009
6/26/2011,137072,90549,35224,262845,97.06240768
6/27/2011,137292,90594,35016,262902,97.08345643
6/28/2011,137328,90579,34784,262691,97.00553914
6/29/2011,138076,90838,34853,263767,97.40288035
6/30/2011,138627,91294,34734,264655,97.73079764
7/1/2011,138829,91477,34616,264922,97.82939439
7/2/2011,138921,91553,34528,265002,97.85893648
7/3/2011,138995,91583,34478,265056,97.8788774
7/4/2011,140616,93166,35259,269041,99.35044313
7/5/2011,140968,93790,35150,269908,99.67060561
7/6/2011,140820,93622,35075,269517,99.52621861
7/7/2011,140616,93409,34986,269011,99.33936484
7/8/2011,140246,93212,34853,268311,99.08087149
7/9/2011,139859,93059,34749,267667,98.84305761
7/10/2011,139381,92953,34587,266921,98.56757755
7/11/2011,138866,92862,34409,266137,98.27806499
7/12/2011,138314,92740,34233,265287,97.96418021
7/13/2011,137802,92573,34072,264447,97.65398818
7/14/2011,137273,92405,33906,263584,97.33530281
7/15/2011,136763,91994,33708,262465,96.92208272
7/16/2011,136345,91568,33504,261417,96.53508124
7/17/2011,136018,91112,33485,260615,96.23892171
7/18/2011,135656,90655,33461,259772,95.92762186
7/19/2011,135312,90245,33254,258811,95.57274742
7/20/2011,134931,89788,33240,257959,95.25812408
7/21/2011,134516,89286,33216,257018,94.91063516
7/22/2011,134228,88784,32810,255822,94.4689808
7/23/2011,133887,88100,32586,254573,94.0077548
7/24/2011,133473,87363,32562,253398,93.57385524
7/25/2011,133078,86828,32533,252439,93.21971935
7/26/2011,133132,86539,32691,252362,93.19128508
7/27/2011,132844,86149,32719,251712,92.95125554
7/28/2011,132469,85774,32529,250772,92.60413589
7/29/2011,132129,85528,32377,250034,92.33161004
7/30/2011,131755,85354,32213,249322,92.06868538
7/31/2011,131291,85123,32000,248414,91.73338257
8/1/2011,130848,84863,31774,247485,91.39032496
8/2/2011,130493,84646,31569,246708,91.10339734
8/3/2011,130014,84371,31354,245739,90.74556869
8/4/2011,129642,84285,31146,245073,90.49963072
8/5/2011,129201,84039,30943,244183,90.17097489
8/6/2011,128761,83605,30730,243096,89.76957164
8/7/2011,128479,83359,30666,242504,89.55096012
8/8/2011,128075,83099,30533,241707,89.25664697
8/9/2011,127670,82724,30515,240909,88.96196455
8/10/2011,127653,82449,30621,240723,88.89327917
8/11/2011,127319,82333,30616,240268,88.72525849
8/12/2011,126901,82117,30607,239625,88.48781388
8/13/2011,126447,81885,30588,238920,88.22747415
8/14/2011,126429,81654,30566,238649,88.1274003
8/15/2011,126447,81423,30612,238482,88.06573117
8/16/2011,127495,81336,31911,240742,88.90029542
8/17/2011,128322,81409,32377,242108,89.40472674
8/18/2011,128849,81322,32216,242387,89.5077548
8/19/2011,129412,81120,31892,242424,89.52141802
8/20/2011,129571,80946,31881,242398,89.51181684
8/21/2011,129518,80695,31822,242035,89.37776957
8/22/2011,129784,80502,31724,242010,89.36853767
8/23/2011,129642,80322,31728,241692,89.25110783
8/24/2011,129394,80032,31789,241215,89.07496307
8/25/2011,128989,79755,31771,240515,88.81646972
8/26/2011,129025,79686,31704,240415,88.7795421
8/27/2011,128937,79783,31713,240433,88.78618907
8/28/2011,130795,80364,32615,243774,90.01994092
8/29/2011,145341,87623,35658,268622,99.1957164
8/30/2011,143462,92512,35304,271278,100.176514
8/31/2011,142397,94018,35180,271595,100.2935746
9/1/2011,141820,94489,35110,271419,100.228582
9/2/2011,141301,94520,35085,270906,100.0391433
9/3/2011,140894,94307,35085,270286,99.81019202
9/4/2011,140690,93972,35110,269772,99.62038405
9/5/2011,141264,94079,35160,270503,99.89032496
9/6/2011,141839,95174,35339,272352,100.5731167
9/7/2011,143629,97025,36009,276663,102.1650665
9/8/2011,145755,103770,35598,285123,105.2891433
9/9/2011,144399,105494,35419,285312,105.3589365
9/10/2011,142995,102965,35224,281184,103.8345643
9/11/2011,142230,101033,35165,278428,102.816839
9/12/2011,141783,100019,35150,276952,102.2717873
9/13/2011,141338,98893,35090,275321,101.6694978
9/14/2011,141005,97911,35075,273991,101.1783604
9/15/2011,140746,97186,35060,272992,100.8094535
9/16/2011,140690,96736,35045,272471,100.6170606
9/17/2011,140542,96269,35031,271842,100.3847858
9/18/2011,140375,95803,35021,271199,100.1473412
9/19/2011,140227,95326,35016,270569,99.91469719
9/20/2011,139951,94839,35001,269791,99.6274003
9/21/2011,139472,94337,34971,268780,99.25406204
9/22/2011,138940,93774,34981,267695,98.85339734
9/23/2011,138425,93090,35031,266546,98.42909897
9/24/2011,138076,92923,35145,266144,98.28064993
9/25/2011,137857,92694,35120,265671,98.10598227
9/26/2011,137510,92147,35080,264737,97.76107829
9/27/2011,137273,91340,35036,263649,97.35930576
9/28/2011,137547,91248,35165,263960,97.47415066
9/29/2011,138113,92025,35404,265542,98.05834564
9/30/2011,140431,93470,35419,269320,99.4534712
10/1/2011,141283,94352,35239,270874,100.0273264
10/2/2011,141468,94885,35170,271523,100.2669867
10/3/2011,141449,95371,35165,271985,100.4375923
10/4/2011,141246,95341,35120,271707,100.3349335
10/5/2011,141023,94930,35090,271043,100.0897341
10/6/2011,140765,94291,35055,270111,99.74556869
10/7/2011,140412,93531,35041,268984,99.32939439
10/8/2011,140171,92679,35036,267886,98.9239291
10/9/2011,139840,91751,35026,266617,98.45531758
10/10/2011,139491,90792,35011,265294,97.96676514
10/11/2011,139105,89743,35001,263849,97.433161
10/12/2011,138903,88678,34991,262572,96.96159527
10/13/2011,138811,87623,34991,261425,96.53803545
10/14/2011,138682,86669,35036,260387,96.15472674
10/15/2011,139455,86207,35145,260807,96.30982275
10/16/2011,139656,85716,35095,260467,96.18426883
10/17/2011,139767,85080,35085,259932,95.98670606
10/18/2011,139767,84747,35070,259584,95.85819793
10/19/2011,139693,84675,35011,259379,95.78249631
10/20/2011,139528,84863,35016,259407,95.79283604
10/21/2011,139472,85239,35036,259747,95.91838996
10/22/2011,139308,85383,35021,259712,95.90546529
10/23/2011,139050,85441,35006,259497,95.8260709
10/24/2011,138811,85456,34996,259263,95.73966027
10/25/2011,138516,85398,34976,258890,95.60192024
10/26/2011,138241,85282,34956,258479,95.45014771
10/27/2011,137985,85196,34961,258142,95.32570162
10/28/2011,137930,85282,34873,258085,95.30465288
10/29/2011,137693,85326,34700,257719,95.16949778
10/30/2011,137657,85383,34635,257675,95.15324963
10/31/2011,137638,85398,34621,257657,95.14660266
11/1/2011,137601,85427,34606,257634,95.13810931
11/2/2011,137657,85427,34345,257429,95.06240768
11/3/2011,137638,85412,33944,256994,94.90177253
11/4/2011,137401,85441,33548,256390,94.67872969
11/5/2011,137218,85398,33341,255957,94.51883309
11/6/2011,137036,85326,33125,255487,94.34527326
11/7/2011,136781,85210,32905,254896,94.12703102
11/8/2011,136544,85065,32691,254300,93.90694239
11/9/2011,136253,84906,32481,253640,93.66322009
11/10/2011,136000,84704,32260,252964,93.41358936
11/11/2011,135801,84545,32042,252388,93.20088626
11/12/2011,135493,84371,32027,251891,93.01735598
11/13/2011,135203,84140,31990,251333,92.81129985
11/14/2011,134859,83865,31953,250677,92.56905465
11/15/2011,134588,83648,31939,250175,92.38367799
11/16/2011,134336,83446,31920,249702,92.20901034
11/17/2011,133995,83330,31939,249264,92.04726736
11/18/2011,133725,83172,31925,248822,91.88404727
11/19/2011,133473,82955,31901,248329,91.70199409
11/20/2011,133186,82724,31873,247783,91.50036928
11/21/2011,132880,82507,31846,247233,91.29726736
11/22/2011,132576,82261,31813,246650,91.08197932
11/23/2011,132737,82391,31948,247076,91.23929099
11/24/2011,133635,83504,32269,249408,92.10044313
11/25/2011,134120,84183,32386,250689,92.57348597
11/26/2011,134390,84661,32472,251523,92.88146233
11/27/2011,134570,85051,32533,252154,93.11447563
11/28/2011,134624,85253,32572,252449,93.22341211
11/29/2011,134606,85369,32596,252571,93.26846381
11/30/2011,135004,86149,32948,254101,93.83345643
12/1/2011,135475,86655,33211,255341,94.29135894
12/2/2011,135910,86814,33345,256069,94.56019202
12/3/2011,136308,86828,33446,256582,94.74963072
12/4/2011,136472,86698,33523,256693,94.79062038
12/5/2011,136636,86496,33601,256733,94.80539143
12/6/2011,136781,86308,33664,256753,94.81277696
12/7/2011,137127,86193,33794,257114,94.94608567
12/8/2011,139252,87305,34705,261262,96.47784343
12/9/2011,140671,88404,35130,264205,97.56462334
12/10/2011,141301,88997,35165,265463,98.02917282
12/11/2011,141412,89332,35125,265869,98.17909897
12/12/2011,141079,89454,35095,265628,98.0901034
12/13/2011,140765,89195,35080,265040,97.87296898
12/14/2011,140579,88632,35070,264281,97.59268833
12/15/2011,140412,88130,35070,263612,97.34564254
12/16/2011,140394,87753,35055,263202,97.19423929
12/17/2011,140190,87334,35050,262574,96.96233383
12/18/2011,139895,86799,35045,261739,96.65398818
12/19/2011,139564,86236,35031,260831,96.31868538
12/20/2011,139252,85947,35016,260215,96.09121123
12/21/2011,138811,85803,35016,259630,95.87518464
12/22/2011,138700,86091,35070,259861,95.96048744
12/23/2011,138645,86525,35110,260280,96.11521418
12/24/2011,138793,87175,35110,261078,96.4098966
12/25/2011,138664,87580,35085,261329,96.50258493
12/26/2011,138498,87811,35070,261379,96.52104874
12/27/2011,138314,87970,35055,261339,96.5062777
12/28/2011,138848,88419,35204,262471,96.92429838
12/29/2011,138958,88845,35130,262933,97.09490399
12/30/2011,139179,88693,35095,262967,97.10745938
12/31/2011,139326,88435,35085,262846,97.06277696
1/1/2012,139381,88146,35075,262602,96.97267356
1/2/2012,139418,87768,35070,262256,96.84490399
1/3/2012,139271,87349,35050,261670,96.62850812
1/4/2012,139068,86713,35006,260787,96.30243722
1/5/2012,138627,86135,34996,259758,95.92245199
1/6/2012,138369,85947,35011,259327,95.76329394
1/7/2012,138058,85759,35011,258828,95.57902511
1/8/2012,137748,85513,35001,258262,95.37001477
1/9/2012,137401,85326,34981,257708,95.16543575
1/10/2012,136908,85239,34981,257128,94.95125554
1/11/2012,136454,85456,34941,256851,94.84896603
1/12/2012,136073,85513,34946,256532,94.73116691
1/13/2012,135982,85716,35011,256709,94.7965288
1/14/2012,135765,85875,35001,256641,94.77141802
1/15/2012,135221,85831,34966,256018,94.54135894
1/16/2012,134516,85600,34912,255028,94.17577548
1/17/2012,133977,85412,34907,254296,93.90546529
1/18/2012,133635,85600,34907,254142,93.84859675
1/19/2012,133132,85889,34887,253908,93.76218612
1/20/2012,132647,85933,34858,253438,93.58862629
1/21/2012,132255,86005,34837,253097,93.4627031
1/22/2012,131719,86005,34828,252552,93.26144756
1/23/2012,131220,85990,34808,252018,93.06425406
1/24/2012,130866,86178,34878,251922,93.02880355
1/25/2012,130617,86568,34981,252166,93.11890694
1/26/2012,130263,86742,34976,251981,93.05059084
1/27/2012,130404,87060,35060,252524,93.25110783
1/28/2012,131523,88359,35294,255176,94.23042836
1/29/2012,132058,88937,35170,256165,94.59564254
1/30/2012,132308,89332,35105,256745,94.80982275
1/31/2012,132434,89210,35080,256724,94.80206795
2/1/2012,132469,88937,35075,256481,94.71233383
2/2/2012,132308,88617,35080,256005,94.53655835
2/3/2012,132058,88237,35065,255360,94.29837518
2/4/2012,131666,87695,35050,254411,93.94793205
2/5/2012,131309,87016,35041,253366,93.5620384
2/6/2012,130848,86250,35026,252124,93.10339734
2/7/2012,130351,86005,34991,251347,92.81646972
2/8/2012,129855,85716,34986,250557,92.52474151
2/9/2012,129341,85629,34976,249946,92.29911374
2/10/2012,128743,85586,34803,249132,91.9985229
2/11/2012,128093,85571,34725,248389,91.72415066
2/12/2012,127407,85571,34720,247698,91.4689808
2/13/2012,126726,85513,34689,246928,91.18463811
2/14/2012,126079,85484,34675,246238,90.92983752
2/15/2012,125488,85457,34660,245605,90.69608567
2/16/2012,125140,85383,34443,244966,90.46011817
2/17/2012,124984,85354,34204,244542,90.30354505
2/18/2012,124620,85239,34101,243960,90.08862629
2/19/2012,124135,85094,34077,243306,89.84711965
2/20/2012,123635,84849,34042,242526,89.55908419
2/21/2012,123084,84617,33998,241699,89.25369276
2/22/2012,122773,84386,33713,240872,88.94830133
2/23/2012,122344,84183,33441,239968,88.61447563
2/24/2012,122275,84010,33192,239477,88.433161
2/25/2012,122224,83851,33091,239166,88.3183161
2/26/2012,122121,83692,33048,238861,88.20568685
2/27/2012,122036,83461,33000,238497,88.07127031
2/28/2012,121933,83215,32719,237867,87.83862629
2/29/2012,121831,83042,32410,237283,87.62296898
3/1/2012,121677,82883,32155,236715,87.41322009
3/2/2012,121643,82781,31878,236302,87.26070901
3/3/2012,121436,82550,31774,235760,87.0605613
3/4/2012,121300,82579,31771,235650,87.01994092
3/5/2012,121129,82666,31733,235528,86.97488922
3/6/2012,120872,82593,31447,234912,86.74741507
3/7/2012,120531,82536,31146,234213,86.48929099
3/8/2012,120395,82478,30859,233732,86.31166913
3/9/2012,120395,82969,30703,234067,86.43537666
3/10/2012,121112,83894,30786,235792,87.07237814
3/11/2012,121419,84473,30896,236788,87.44017725
3/12/2012,121728,85008,30998,237734,87.78951256
3/13/2012,121985,85456,30989,238430,88.0465288
3/14/2012,122258,85745,31108,239111,88.29800591
3/15/2012,122550,86106,31220,239876,88.58050222
3/16/2012,122688,86438,31401,240527,88.82090103
3/17/2012,122791,86771,31578,241140,89.04726736
3/18/2012,122860,87031,31752,241643,89.23301329
3/19/2012,122860,87219,31920,241999,89.36447563
3/20/2012,123394,87508,32173,243075,89.76181684
3/21/2012,123790,87609,32236,243635,89.96861152
3/22/2012,124222,87724,32207,244153,90.1598966
3/23/2012,124585,87883,32137,244605,90.32680945
3/24/2012,124828,87912,32023,244763,90.3851551
3/25/2012,125071,88013,31892,244976,90.46381093
3/26/2012,125245,88100,31756,245101,90.50997046
3/27/2012,125175,88161,31704,245040,90.48744461
3/28/2012,125157,88115,31691,244963,90.45901034
3/29/2012,125036,88042,31663,244741,90.37703102
3/30/2012,125019,87970,31620,244609,90.32828656
3/31/2012,124932,87912,31606,244450,90.26957164
4/1/2012,124846,87840,31686,244372,90.24076809
4/2/2012,124863,87782,31798,244443,90.26698671
4/3/2012,124846,87739,31789,244374,90.24150665
4/4/2012,124673,87609,31771,244053,90.12296898
4/5/2012,124551,87479,31728,243758,90.0140325
4/6/2012,124464,87363,31663,243490,89.91506647
4/7/2012,124343,87161,31620,243124,89.77991137
4/8/2012,124239,86958,31667,242864,89.68389956
4/9/2012,124031,86727,31710,242468,89.53766617
4/10/2012,124014,86626,31771,242411,89.51661743
4/11/2012,123979,86511,31789,242279,89.46787297
4/12/2012,123893,86453,31832,242178,89.43057607
4/13/2012,123722,86265,31868,241855,89.31129985
4/14/2012,123480,86048,31905,241433,89.15546529
4/15/2012,123204,85803,31939,240946,88.97562777
4/16/2012,122981,85586,31962,240529,88.82163959
4/17/2012,122722,85340,32009,240071,88.65251108
4/18/2012,122395,85123,32000,239518,88.44830133
4/19/2012,122190,85080,32027,239297,88.36669129
4/20/2012,122121,85123,32052,239296,88.36632201
4/21/2012,122173,85051,32014,239238,88.34490399
4/22/2012,122412,85152,32075,239639,88.49298375
4/23/2012,123067,85687,32335,241089,89.02843427
4/24/2012,124014,86583,32557,243154,89.79098966
4/25/2012,124879,87161,32515,244555,90.30834564
4/26/2012,125661,87609,32363,245633,90.70642541
4/27/2012,126289,87999,32140,246428,91
4/28/2012,126795,88328,31981,247104,91.24963072
4/29/2012,127355,88541,31704,247600,91.43279173
4/30/2012,127670,88678,31411,247759,91.49150665
5/1/2012,127952,88784,31127,247863,91.52991137
5/2/2012,128233,88830,30854,247917,91.54985229
5/3/2012,128602,88921,30644,248167,91.64217134
5/4/2012,129060,89073,30483,248616,91.80797637
5/5/2012,129430,89241,30566,249237,92.0372969
5/6/2012,129713,89317,30675,249705,92.21011817
5/7/2012,130032,89347,30753,250132,92.36779911
5/8/2012,130334,89393,30836,250563,92.52695716
5/9/2012,131113,89910,31461,252484,93.23633678
5/10/2012,131737,90594,31808,254139,93.84748892
5/11/2012,132165,90990,32052,255207,94.24187592
5/12/2012,132361,91112,32227,255700,94.4239291
5/13/2012,132773,91051,32358,256182,94.60192024
5/14/2012,133168,90959,32491,256618,94.76292467
5/15/2012,133797,91066,32810,257673,95.15251108
5/16/2012,136763,92892,34473,264128,97.53618907
5/17/2012,138388,94291,34912,267591,98.81499261
5/18/2012,139455,95189,34788,269432,99.49483013
5/19/2012,140043,95851,34645,270539,99.90361891
5/20/2012,140246,96317,34523,271086,100.105613
5/21/2012,140264,96559,34379,271202,100.148449
5/22/2012,140690,96366,34443,271499,100.2581241
5/23/2012,140950,96269,34587,271806,100.3714919
5/24/2012,140876,96334,35050,272260,100.5391433
5/25/2012,140820,96205,35070,272095,100.4782127
5/26/2012,140671,95883,35095,271649,100.3135155
5/27/2012,140320,95554,35085,270959,100.0587149
5/28/2012,140116,95204,35080,270400,99.85228951
5/29/2012,139914,94839,35075,269828,99.64106352
5/30/2012,140264,94717,35189,270170,99.76735598
5/31/2012,140190,94565,35075,269830,99.64180207
6/1/2012,139961,94368,34961,269290,99.44239291
6/2/2012,139822,94170,34907,268899,99.29800591
6/3/2012,139730,93987,34931,268648,99.20531758
6/4/2012,139656,93805,34892,268353,99.09638109
6/5/2012,139748,93729,34882,268359,99.09859675
6/6/2012,139693,93546,34808,268047,98.98338257
6/7/2012,139528,93394,34769,267691,98.85192024
6/8/2012,139345,93227,34665,267237,98.68426883
6/9/2012,139160,92968,34587,266715,98.49150665
6/10/2012,138995,92710,34518,266223,98.30982275
6/11/2012,138811,92466,34438,265715,98.12223043
6/12/2012,138572,92131,34335,265038,97.87223043
6/13/2012,138535,92116,34483,265134,97.90768095
6/14/2012,138369,92055,34497,264921,97.82902511
6/15/2012,138040,91903,34404,264347,97.61706056
6/16/2012,137657,91736,34262,263655,97.36152142
6/17/2012,137255,91553,34111,262919,97.08973412
6/18/2012,136927,91340,33964,262231,96.83567208
6/19/2012,136526,91142,33915,261583,96.59638109
6/20/2012,136109,90914,33939,260962,96.36706056
6/21/2012,135711,90594,33722,260027,96.0217873
6/22/2012,135276,90290,33499,259065,95.66654357
6/23/2012,134859,90062,33187,258108,95.31314623
6/24/2012,134390,89819,32995,257204,94.97932053
6/25/2012,133977,89606,32824,256407,94.68500739
6/26/2012,133527,89347,32624,255498,94.3493353
6/27/2012,133096,89104,32425,254625,94.02695716
6/28/2012,132594,88830,32216,253640,93.66322009
6/29/2012,132361,88328,32009,252698,93.31536189
6/30/2012,132093,87695,31691,251479,92.86521418
7/1/2012,131612,87016,31480,250108,92.35893648
7/2/2012,131274,86323,31285,248882,91.90620384
7/3/2012,131220,85716,31062,247998,91.57976366
7/4/2012,131185,85094,30841,247120,91.25553914
7/5/2012,131149,84458,30634,246241,90.93094535
7/6/2012,131149,83793,30415,245357,90.60450517
7/7/2012,131078,83070,30191,244339,90.22858198
7/8/2012,131043,82333,29968,243344,89.86115214
7/9/2012,131007,81582,29737,242326,89.48522895
7/10/2012,130954,80961,29468,241383,89.13700148
7/11/2012,130635,80156,28959,239750,88.53397341
7/12/2012,130564,79562,28530,238656,88.12998523
7/13/2012,130457,78982,28110,237549,87.72119645
7/14/2012,130263,78374,27705,236342,87.27548006
7/15/2012,130156,77793,27322,235271,86.87998523
7/16/2012,130226,77462,27090,234778,86.69793205
7/17/2012,130173,76882,26689,233744,86.31610044
7/18/2012,130067,76274,26240,232581,85.8866322
7/19/2012,130014,75680,25796,231490,85.48375185
7/20/2012,129996,75141,25408,230545,85.13478582
7/21/2012,129979,74478,25184,229641,84.80096012
7/22/2012,129837,73728,24969,228534,84.39217134
7/23/2012,129448,73040,24887,227375,83.96418021
7/24/2012,129077,72669,24813,226559,83.66285081
7/25/2012,128567,72284,24662,225513,83.27658789
7/26/2012,128075,71940,24629,224644,82.95568685
7/27/2012,127688,71795,24674,224157,82.77584934
7/28/2012,127093,71636,24670,223399,82.49593796
7/29/2012,126936,71569,24756,223261,82.44497784
7/30/2012,126482,71503,24817,222802,82.27548006
7/31/2012,125974,71358,24817,222149,82.03434269
8/1/2012,125436,71212,24793,221441,81.77289513
8/2/2012,124863,71066,24739,220668,81.48744461
8/3/2012,124343,70920,24703,219966,81.2282127
8/4/2012,123790,70709,24519,219018,80.87813885
8/5/2012,123222,70523,24478,218223,80.58456425
8/6/2012,122636,70391,24470,217497,80.31646972
8/7/2012,122087,69953,24430,216470,79.93722304
8/8/2012,121540,69437,24381,215358,79.52658789
8/9/2012,120941,68960,24323,214224,79.10782866
8/10/2012,120514,68550,24287,213351,78.78545052
8/11/2012,120055,68126,24246,212427,78.44423929
8/12/2012,119512,67781,24413,211706,78.17799114
8/13/2012,119002,67397,24417,210816,77.8493353
8/14/2012,118428,67037,24393,209858,77.49556869
8/15/2012,117939,66732,24368,209039,77.19313146
8/16/2012,117451,66388,24389,208228,76.89364845
8/17/2012,116913,66032,24376,207321,76.55871492
8/18/2012,116428,65701,24364,206493,76.25295421
8/19/2012,115876,65357,24311,205544,75.90251108
8/20/2012,115310,64975,24279,204564,75.54062038
8/21/2012,114795,64644,24246,203685,75.21602659
8/22/2012,114246,64198,24205,202649,74.83345643
8/23/2012,113683,63816,24173,201672,74.47267356
8/24/2012,113140,63370,24108,200618,74.08345643
8/25/2012,112563,62925,23858,199346,73.61373708
8/26/2012,112004,62492,23805,198301,73.22784343
8/27/2012,111447,62021,23761,197229,72.83197932
8/28/2012,111089,61766,23717,196572,72.58936484
8/29/2012,110582,61562,23701,195845,72.32090103
8/30/2012,110046,61231,23665,194942,71.98744461
8/31/2012,109478,60817,23605,193900,71.60265879
9/1/2012,108920,60341,23413,192674,71.14992614
9/2/2012,108379,59865,23366,191610,70.75701625
9/3/2012,107814,59499,23310,190623,70.39254062
9/4/2012,107268,59132,23282,189682,70.0450517
9/5/2012,106740,58803,23294,188837,69.73301329
9/6/2012,106340,58424,23389,188153,69.48042836
9/7/2012,105892,57960,23389,187241,69.14364845
9/8/2012,105415,57533,23374,186322,68.8042836
9/9/2012,105082,57264,23429,185775,68.60228951
9/10/2012,104606,56886,23445,184937,68.29283604
9/11/2012,104066,56385,23437,183888,67.90546529
9/12/2012,103594,55872,23382,182848,67.52141802
9/13/2012,103090,55396,23354,181840,67.14918759
9/14/2012,102601,54871,23306,180778,66.75701625
9/15/2012,102148,54288,23282,179718,66.36558346
9/16/2012,101648,53716,23234,178598,65.95199409
9/17/2012,101195,53085,23199,177479,65.538774
9/18/2012,100745,52724,23175,176644,65.23042836
9/19/2012,102476,52770,27749,182995,67.57570162
9/20/2012,103105,53062,28320,184487,68.12666174
9/21/2012,103168,53132,28587,184887,68.27437223
9/22/2012,102900,53121,28641,184662,68.19128508
9/23/2012,102648,53132,28929,184709,68.20864106
9/24/2012,102320,53132,29070,184522,68.13958641
9/25/2012,101961,53074,29163,184198,68.01994092
9/26/2012,101586,52840,29204,183630,67.81019202
9/27/2012,101211,52572,29288,183071,67.60376662
9/28/2012,100946,52467,29342,182755,67.48707533
9/29/2012,100978,52992,29584,183554,67.78212703
9/30/2012,100838,53354,30137,184329,68.0683161
10/1/2012,100590,53552,30287,184429,68.10524372
10/2/2012,100311,53774,30433,184518,68.13810931
10/3/2012,100032,53961,30584,184577,68.1598966
10/4/2012,99675,54159,30712,184546,68.14844904
10/5/2012,99660,54346,30882,184888,68.27474151
10/6/2012,99428,54544,31026,184998,68.31536189
10/7/2012,99197,54684,31146,185027,68.3260709
10/8/2012,98983,54789,31257,185029,68.32680945
10/9/2012,98644,54895,31354,184893,68.27658789
10/10/2012,98352,55005,31438,184795,68.24039882
10/11/2012,98014,55079,31518,184611,68.17245199
10/12/2012,97664,54969,31625,184258,68.04209749
10/13/2012,97389,54848,31713,183950,67.92836041
10/14/2012,96992,54696,31789,183477,67.75369276
10/15/2012,96673,54568,31864,183105,67.61632201
10/16/2012,96325,54428,31957,182710,67.4704579
10/17/2012,95993,54311,32009,182313,67.32385524
10/18/2012,95584,54159,32009,181752,67.11669129
10/19/2012,95327,54101,32108,181536,67.03692762
10/20/2012,96279,56471,33201,185951,68.66728213
10/21/2012,97161,58046,33644,188851,69.73818316
10/22/2012,97786,59059,33910,190755,70.44128508
10/23/2012,97953,59804,34101,191858,70.84859675
10/24/2012,98198,60732,34365,193295,71.37924668
10/25/2012,98229,61562,34611,194402,71.78803545
10/26/2012,98260,62237,34769,195266,72.1070901
10/27/2012,98690,62823,34848,196361,72.51144756
10/28/2012,99106,63344,34936,197386,72.88995569
10/29/2012,99428,63802,35026,198256,73.211226
10/30/2012,100962,64478,35150,200590,74.07311669
10/31/2012,102775,65726,35329,203830,75.26957164
11/1/2012,103672,66363,35219,205254,75.79542097
11/2/2012,104383,66885,35150,206418,76.22525849
11/3/2012,104827,67715,35095,207637,76.6754062
11/4/2012,105098,68523,35065,208686,77.06277696
11/5/2012,105177,69225,35050,209452,77.34564254
11/6/2012,105177,69768,35041,209986,77.54283604
11/7/2012,105129,70218,35031,210378,77.68759232
11/8/2012,105018,70629,35016,210663,77.79283604
11/9/2012,104875,70788,34976,210639,77.78397341
11/10/2012,104669,70801,34971,210441,77.71085672
11/11/2012,104526,70761,34961,210248,77.63958641
11/12/2012,104240,70682,34956,209878,77.50295421
11/13/2012,104082,70695,34961,209738,77.45125554
11/14/2012,104066,70881,35031,209978,77.53988183
11/15/2012,103767,70960,35026,209753,77.45679468
11/16/2012,103563,70973,35011,209547,77.38072378
11/17/2012,103452,70973,34996,209421,77.33419498
11/18/2012,103262,70960,34981,209203,77.25369276
11/19/2012,103121,70907,34956,208984,77.17282127
11/20/2012,102916,70841,34936,208693,77.06536189
11/21/2012,102727,70735,34912,208374,76.94756278
11/22/2012,102523,70629,34868,208020,76.816839
11/23/2012,102289,70497,34823,207609,76.66506647
11/24/2012,102117,70351,34784,207252,76.53323486
11/25/2012,101898,70218,34725,206841,76.38146233
11/26/2012,101617,70046,34680,206343,76.19756278
11/27/2012,101382,69874,34645,205901,76.03434269
11/28/2012,101133,69689,34587,205409,75.85265879
11/29/2012,100823,69477,34538,204838,75.64180207
11/30/2012,100513,69251,34365,204129,75.37998523
12/1/2012,100203,69013,34219,203435,75.12370753
12/2/2012,99955,68775,34160,202890,74.92245199
12/3/2012,99722,68589,34101,202412,74.74593796
12/4/2012,99428,68364,33964,201756,74.50369276
12/5/2012,99197,68179,33813,201189,74.29431315
12/6/2012,98921,68033,33746,200700,74.11373708
12/7/2012,98705,67874,33674,200253,73.94867061
12/8/2012,98583,67808,33606,199997,73.85413589
12/9/2012,98568,67728,33679,199975,73.84601182
12/10/2012,98522,67689,33741,199952,73.83751846
12/11/2012,98767,67808,33784,200359,73.98781388
12/12/2012,99044,68099,33756,200899,74.18722304
12/13/2012,99305,68298,33746,201349,74.35339734
12/14/2012,99520,68470,33713,201703,74.48412112
12/15/2012,99753,68603,33553,201909,74.56019202
12/16/2012,99908,68722,33625,202255,74.6879616
12/17/2012,100032,68815,33693,202540,74.79320532
12/18/2012,100466,69027,33669,203162,75.02289513
12/19/2012,100993,69649,33891,204533,75.52917282
12/20/2012,101117,70112,33910,205139,75.75295421
12/21/2012,101680,70616,33901,206197,76.14364845
12/22/2012,104224,72801,34922,211947,78.26698671
12/23/2012,105621,74298,34996,214915,79.36299852
12/24/2012,106708,75472,35001,217181,80.19977843
12/25/2012,107557,76426,34986,218969,80.86004431
12/26/2012,108233,77213,34917,220363,81.37481536
12/27/2012,108830,77945,34853,221628,81.84194978
12/28/2012,109429,78291,34764,222484,82.15805022
12/29/2012,109657,78498,34660,222815,82.28028065
12/30/2012,109883,78692,34557,223132,82.39734121
12/31/2012,109916,78788,34423,223127,82.39549483
1/1/2013,109932,78816,34276,223024,82.35745938
1/2/2013,109916,78844,34145,222905,82.31351551
1/3/2013,109900,78802,33974,222676,82.22895126
1/4/2013,109819,78733,33813,222365,82.11410635
1/5/2013,109721,78664,33644,222029,81.99002954
1/6/2013,109673,78595,33485,221753,81.88810931
1/7/2013,109608,78470,33321,221399,81.75738552
1/8/2013,109510,78374,33144,221028,81.62038405
1/9/2013,109396,78235,32981,220612,81.46676514
1/10/2013,109251,78042,32800,220093,81.27511078
1/11/2013,109137,77904,32628,219669,81.11853767
1/12/2013,109008,77752,32472,219232,80.95716396
1/13/2013,108992,77752,32321,219065,80.89549483
1/14/2013,109332,78222,32241,219795,81.16506647
1/15/2013,110095,78996,32279,221370,81.74667651
1/16/2013,110941,79700,32250,222891,82.30834564
1/17/2013,111579,80322,32146,224047,82.73522895
1/18/2013,112234,80765,32036,225035,83.10007386
1/19/2013,112761,81062,31995,225818,83.38921713
1/20/2013,113239,81308,32000,226547,83.6584195
1/21/2013,113617,81481,32009,227107,83.86521418
1/22/2013,114031,81597,31986,227614,84.05243722
1/23/2013,114197,81510,31934,227641,84.06240768
1/24/2013,114429,81365,31868,227662,84.07016248
1/25/2013,114595,81177,31803,227575,84.03803545
1/26/2013,114795,81062,31771,227628,84.05760709
1/27/2013,114978,80917,31742,227637,84.06093058
1/28/2013,115177,80778,31686,227641,84.06240768
1/29/2013,115343,80668,31658,227669,84.07274742
1/30/2013,115692,80723,31643,228058,84.21639586
1/31/2013,116663,81755,32066,230484,85.11225997
2/1/2013,118056,83403,32848,234307,86.52400295
2/2/2013,118816,84342,33033,236191,87.21971935
2/3/2013,119631,85109,33144,237884,87.84490399
2/4/2013,120259,85803,33230,239292,88.3648449
2/5/2013,120770,86077,33278,240125,88.67245199
2/6/2013,121112,86091,33273,240476,88.80206795
2/7/2013,121146,85990,33158,240294,88.73485968
2/8/2013,121248,85817,33029,240094,88.66100443
2/9/2013,121334,85701,32900,239935,88.60228951
2/10/2013,121351,85441,32747,239539,88.45605613
2/11/2013,121402,85398,32600,239400,88.40472674
2/12/2013,121419,85383,32463,239265,88.35487445
2/13/2013,121402,85282,32302,238986,88.25184638
2/14/2013,121385,85065,32146,238596,88.10782866
2/15/2013,121334,84632,31995,237961,87.87333826
2/16/2013,121317,84227,31813,237357,87.65029542
2/17/2013,121231,83750,31625,236606,87.37296898
2/18/2013,121095,83475,31415,235985,87.14364845
2/19/2013,120992,83273,31220,235485,86.95901034
2/20/2013,120787,83099,31053,234939,86.75738552
2/21/2013,120480,82868,30735,234083,86.44128508
2/22/2013,120225,82637,30415,233277,86.14364845
2/23/2013,119936,82406,30100,232442,85.83530281
2/24/2013,119631,82175,29805,231611,85.52843427
2/25/2013,119359,81943,29518,230820,85.23633678
2/26/2013,119070,81712,29252,230034,84.94608567
2/27/2013,118765,81495,28985,229245,84.65472674
2/28/2013,118394,81409,28782,228585,84.41100443
3/1/2013,118158,81336,28530,228024,84.20384047
3/2/2013,117922,81206,28263,227391,83.97008863
3/3/2013,117635,81047,27992,226674,83.70531758
3/4/2013,117316,80847,27714,225877,83.41100443
3/5/2013,116981,80654,27524,225159,83.14586411
3/6/2013,116646,80419,27344,224409,82.86890694
3/7/2013,116278,80184,27219,223681,82.60007386
3/8/2013,116076,80004,27107,223187,82.4176514
3/9/2013,115859,79783,26974,222616,82.20679468
3/10/2013,115592,79562,26864,222018,81.9859675
3/11/2013,115442,79396,26749,221587,81.82680945
3/12/2013,115608,79603,26727,221938,81.95642541
3/13/2013,118934,82839,28646,230419,85.08825702
3/14/2013,120684,85167,29168,235019,86.78692762
3/15/2013,121660,86756,29297,237713,87.78175775
3/16/2013,122361,87551,29428,239340,88.38257016
3/17/2013,122894,88071,29566,240531,88.82237814
3/18/2013,123256,88206,29670,241132,89.04431315
3/19/2013,123722,88222,29783,241727,89.2640325
3/20/2013,124048,88222,29892,242162,89.42466765
3/21/2013,124187,88206,29923,242316,89.48153619
3/22/2013,124274,87999,29977,242250,89.45716396
3/23/2013,124308,87739,30050,242097,89.4006647
3/24/2013,124291,87479,30095,241865,89.31499261
3/25/2013,124274,87175,30141,241590,89.21344165
3/26/2013,124205,86843,30164,241212,89.07385524
3/27/2013,124153,86525,30150,240828,88.93205318
3/28/2013,124118,86193,30086,240397,88.77289513
3/29/2013,123911,85875,30077,239863,88.57570162
3/30/2013,123704,85542,30114,239360,88.38995569
3/31/2013,123462,85297,30168,238927,88.23005908
4/1/2013,123325,85152,30264,238741,88.16137371
4/2/2013,123359,85210,30410,238979,88.24926145
4/3/2013,123394,85253,30487,239134,88.30649926
4/4/2013,123428,85282,30547,239257,88.35192024
4/5/2013,123359,85311,30625,239295,88.36595273
4/6/2013,123308,85326,30707,239341,88.38293944
4/7/2013,123273,85369,30795,239437,88.41838996
4/8/2013,123290,85354,30873,239517,88.44793205
4/9/2013,123342,85398,30993,239733,88.52769572
4/10/2013,123687,85571,31169,240427,88.78397341
4/11/2013,124014,85831,31429,241274,89.09675037
4/12/2013,125297,87117,32137,244551,90.30686854
4/13/2013,126202,88252,32600,247054,91.23116691
4/14/2013,126760,89104,32929,248793,91.87333826
4/15/2013,127128,89773,33158,250059,92.34084195
4/16/2013,127811,90260,33341,251412,92.84047267
4/17/2013,128585,90823,33475,252883,93.38367799
4/18/2013,129236,91401,33563,254200,93.87001477
4/19/2013,129377,91751,33713,254841,94.10672083
4/20/2013,130280,92451,34091,256822,94.83825702
4/21/2013,131274,93592,34414,259280,95.74593796
4/22/2013,132308,94307,34513,261128,96.42836041
4/23/2013,133168,94793,34533,262494,96.93279173
4/24/2013,133941,95234,34473,263648,97.35893648
4/25/2013,134588,95819,34399,264806,97.78655835
4/26/2013,135167,95947,34238,265352,97.98818316
4/27/2013,135693,95899,34150,265742,98.13220089
4/28/2013,136181,95691,34062,265934,98.20310192
4/29/2013,136581,95402,33964,265947,98.20790251
4/30/2013,136854,95341,33829,266024,98.23633678
5/1/2013,137018,95189,33659,265866,98.17799114
5/2/2013,137273,95022,33446,265741,98.13183161
5/3/2013,137528,94885,33235,265648,98.09748892
5/4/2013,137510,94763,33264,265537,98.05649926
5/5/2013,137419,94565,33321,265305,97.97082718
5/6/2013,137292,94383,33374,265049,97.87629247
5/7/2013,137145,94200,33413,264758,97.76883309
5/8/2013,137000,94002,33475,264477,97.66506647
5/9/2013,137255,94200,33679,265134,97.90768095
5/10/2013,137346,94170,33809,265325,97.9782127
5/11/2013,137328,94094,33929,265351,97.98781388
5/12/2013,137601,94094,34175,265870,98.17946824
5/13/2013,137802,94002,34224,266028,98.23781388
5/14/2013,137966,93896,34228,266090,98.26070901
5/15/2013,138003,93835,34204,266042,98.24298375
5/16/2013,138040,93759,34155,265954,98.21048744
5/17/2013,137966,93637,34189,265792,98.1506647
5/18/2013,137912,93501,34272,265685,98.11115214
5/19/2013,137766,93348,34355,265469,98.03138848
5/20/2013,137638,93196,34458,265292,97.96602659
5/21/2013,137565,93059,34478,265102,97.89586411
5/22/2013,137601,92907,34438,264946,97.83825702
5/23/2013,137912,93029,34389,265330,97.98005908
5/24/2013,138149,93044,34518,265711,98.12075332
5/25/2013,138645,93333,34715,266693,98.48338257
5/26/2013,139730,94079,34981,268790,99.2577548
5/27/2013,140560,95052,35001,270613,99.93094535
5/28/2013,140801,95722,35016,271539,100.2728951
5/29/2013,140838,96398,35110,272346,100.570901
5/30/2013,141839,97508,35115,274462,101.3522895
5/31/2013,141857,99279,35021,276157,101.9782127
6/1/2013,141672,98716,34813,275201,101.6251846
6/2/2013,141357,97943,34710,274010,101.1853767
6/3/2013,141227,97895,34715,273837,101.1214919
6/4/2013,141098,97782,34596,273476,100.9881832
6/5/2013,140913,97412,34448,272773,100.728582
6/6/2013,140765,96977,34414,272156,100.5007386
6/7/2013,140838,96816,34473,272127,100.4900295
6/8/2013,140894,96784,34695,272373,100.5808715
6/9/2013,140708,96591,34873,272172,100.506647
6/10/2013,140505,96301,34956,271762,100.3552437
6/11/2013,141005,96301,35404,272710,100.7053176
6/12/2013,141468,96768,35289,273525,101.0062777
6/13/2013,141506,96977,35189,273672,101.0605613
6/14/2013,142528,97878,35503,275909,101.8866322
6/15/2013,142845,98442,35349,276636,102.155096
6/16/2013,142453,98474,35204,276131,101.9686115
6/17/2013,142174,98007,35145,275326,101.6713442
6/18/2013,141764,97396,35095,274255,101.2758493
6/19/2013,141098,96864,34981,272943,100.7913589
6/20/2013,140579,96350,34887,271816,100.3751846
6/21/2013,140394,95630,34744,270768,99.98818316
6/22/2013,140246,95082,34611,269939,99.68205318
6/23/2013,140079,94763,34492,269334,99.45864106
6/24/2013,139914,94428,34355,268697,99.22341211
6/25/2013,139840,94185,34224,268249,99.05797637
6/26/2013,139656,94109,34214,267979,98.95827179
6/27/2013,139308,94048,34233,267589,98.81425406
6/28/2013,139619,94748,34360,268727,99.2344904
6/29/2013,139509,95931,34552,269992,99.70162482
6/30/2013,139418,96334,34621,270373,99.84231905
7/1/2013,139436,96301,34710,270447,99.86964549
7/2/2013,139619,96494,34907,271020,100.0812408
7/3/2013,139804,96752,35031,271587,100.2906204
7/4/2013,139840,96189,35065,271094,100.1085672
7/5/2013,139546,95584,35036,270166,99.76587888
7/6/2013,139105,95022,34996,269123,99.38072378
7/7/2013,138811,94550,34808,268169,99.02843427
7/8/2013,138443,94124,34660,267227,98.68057607
7/9/2013,138058,94079,34601,266738,98.5
7/10/2013,137601,93759,34533,265893,98.1879616
7/11/2013,137401,93455,34433,265289,97.96491876
7/12/2013,137218,93105,34286,264609,97.71381093
7/13/2013,136981,92892,34032,263905,97.45384047
7/14/2013,136508,92679,33983,263170,97.18242245
7/15/2013,135928,92481,33969,262378,96.88995569
7/16/2013,135602,92253,33688,261543,96.58161004
7/17/2013,135276,91918,33379,260573,96.22341211
7/18/2013,134714,91462,33216,259392,95.7872969
7/19/2013,134120,91005,33086,258211,95.35118168
7/20/2013,133491,90701,32953,257145,94.95753323
7/21/2013,132934,90427,32895,256256,94.62924668
7/22/2013,132326,90108,32853,255287,94.27141802
7/23/2013,131809,89971,32824,254604,94.01920236
7/24/2013,131541,89788,32795,254124,93.84194978
7/25/2013,131060,89362,32757,253179,93.49298375
7/26/2013,130440,88952,32600,251992,93.05465288
7/27/2013,129819,88419,32543,250781,92.60745938
7/28/2013,129183,87927,32491,249601,92.17171344
7/29/2013,128831,87565,32486,248882,91.90620384
7/30/2013,128409,87190,32472,248071,91.60672083
7/31/2013,128022,86901,32415,247338,91.33604136
8/1/2013,127670,86438,32283,246391,90.98633678
8/2/2013,127706,86034,32213,245953,90.8245938
8/3/2013,127723,85528,31944,245195,90.54468242
8/4/2013,127723,85036,31639,244398,90.25036928
8/5/2013,127688,84487,31322,243497,89.9176514
8/6/2013,127547,83938,30998,242483,89.54320532
8/7/2013,127477,83359,30680,241516,89.18611521
8/8/2013,127460,82825,30383,240668,88.87296898
8/9/2013,127635,82362,30218,240215,88.70568685
8/10/2013,128409,82406,30670,241485,89.17466765
8/11/2013,128585,82247,30538,241370,89.13220089
8/12/2013,128286,81885,30520,240691,88.88146233
8/13/2013,127794,81481,30305,239580,88.47119645
8/14/2013,127565,82016,30055,239636,88.49187592
8/15/2013,127075,82175,29760,239010,88.26070901
8/16/2013,126586,82030,29468,238084,87.91875923
8/17/2013,126079,81741,29159,236979,87.51070901
8/18/2013,125521,81467,29119,236107,87.18870015
8/19/2013,125001,81148,29079,235228,86.86410635
8/20/2013,124447,80792,29039,234278,86.51329394
8/21/2013,123859,80613,28888,233360,86.17429838
8/22/2013,123308,80226,28747,232281,85.77584934
8/23/2013,122739,79811,28609,231159,85.36152142
8/24/2013,122138,79410,28570,230118,84.97710487
8/25/2013,121574,79231,28522,229327,84.68500739
8/26/2013,120992,78816,28482,228290,84.30206795
8/27/2013,120872,78678,28517,228067,84.21971935
8/28/2013,120650,78774,28455,227879,84.15029542
8/29/2013,120514,78788,28508,227810,84.12481536
8/30/2013,120378,78982,28438,227798,84.12038405
8/31/2013,120157,79009,28320,227486,84.00516987
9/1/2013,120004,79203,28320,227527,84.02031019
9/2/2013,119851,79286,28311,227448,83.99113737
9/3/2013,120276,80737,28373,229386,84.70679468
9/4/2013,120191,82073,28386,230650,85.17355982
9/5/2013,119970,82550,28271,230791,85.22562777
9/6/2013,119631,82724,28236,230591,85.15177253
9/7/2013,119308,82839,28202,230349,85.06240768
9/8/2013,118951,82998,28176,230125,84.97968981
9/9/2013,118529,83099,28149,229777,84.85118168
9/10/2013,118107,82955,28097,229159,84.62296898
9/11/2013,117770,82825,28080,228675,84.44423929
9/12/2013,118158,82825,27970,228953,84.54689808
9/13/2013,118462,82984,27983,229429,84.72267356
9/14/2013,118596,83027,27957,229580,84.77843427
9/15/2013,118562,82897,27944,229403,84.71307238
9/16/2013,118462,82666,27896,229024,84.57311669
9/17/2013,118344,82463,27870,228677,84.44497784
9/18/2013,118158,82189,27835,228182,84.26218612
9/19/2013,117905,81943,27796,227644,84.06351551
9/20/2013,117686,81539,27757,226982,83.81905465
9/21/2013,117417,81279,27727,226423,83.61262925
9/22/2013,117081,81062,27705,225848,83.40029542
9/23/2013,116846,80874,27675,225395,83.23301329
9/24/2013,116528,80460,27636,224624,82.94830133
9/25/2013,116194,80032,27597,223823,82.65251108
9/26/2013,115893,79562,27546,223001,82.34896603
9/27/2013,115575,79078,27511,222164,82.03988183
9/28/2013,115144,78664,27455,221263,81.70716396
9/29/2013,114728,78042,27417,220187,81.30982275
9/30/2013,114296,77379,27378,219053,80.89106352
10/1/2013,113914,76578,27326,217818,80.43500739
10/2/2013,113453,75804,27296,216553,79.96787297
10/3/2013,113057,75099,27253,215409,79.54542097
10/4/2013,112958,74588,27215,214761,79.30612999
10/5/2013,112859,73927,27189,213975,79.01587888
10/6/2013,112646,73305,27180,213131,78.70420975
10/7/2013,112299,72814,27176,212289,78.39327917
10/8/2013,112629,73066,27227,212922,78.62703102
10/9/2013,112448,73172,27236,212856,78.60265879
10/10/2013,112415,73106,27202,212723,78.55354505
10/11/2013,112201,73013,27180,212394,78.43205318
10/12/2013,111922,72881,27163,211966,78.27400295
10/13/2013,111611,72682,27124,211417,78.07127031
10/14/2013,111284,72417,27090,210791,77.8401034
10/15/2013,111105,71993,27064,210162,77.60782866
10/16/2013,110892,71517,27018,209427,77.33641064
10/17/2013,110713,71000,26996,208709,77.07127031
10/18/2013,110387,70589,26974,207950,76.79098966
10/19/2013,110063,70311,26877,207251,76.53286558
10/20/2013,109657,69940,26851,206448,76.23633678
10/21/2013,109332,69689,26812,205833,76.00923191
10/22/2013,109089,69212,26782,205083,75.73227474
10/23/2013,108797,68682,26753,204232,75.41802068
10/24/2013,108476,68152,26706,203334,75.08641064
10/25/2013,108088,67476,26680,202244,74.68389956
10/26/2013,107686,66796,26655,201137,74.27511078
10/27/2013,107252,66159,26626,200037,73.86890694
10/28/2013,106884,65561,26600,199045,73.50258493
10/29/2013,106644,64937,26578,198159,73.1754062
10/30/2013,106372,64249,26566,197187,72.81646972
10/31/2013,106100,63689,26557,196346,72.50590842
11/1/2013,105940,63332,26642,195914,72.34638109
11/2/2013,105844,63216,26851,195911,72.34527326
11/3/2013,105605,62823,26936,195364,72.14327917
11/4/2013,105415,62505,26988,194908,71.97488922
11/5/2013,105304,62352,27022,194678,71.88995569
11/6/2013,105129,62161,27073,194363,71.77363368
11/7/2013,105098,62021,27098,194217,71.71971935
11/8/2013,104970,62263,27163,194396,71.78581979
11/9/2013,104779,62250,27215,194244,71.72968981
11/10/2013,104590,62072,27253,193915,71.60819793
11/11/2013,104431,61995,27300,193726,71.53840473
11/12/2013,104161,62161,27331,193653,71.51144756
11/13/2013,103815,62275,27365,193455,71.43833087
11/14/2013,103531,62339,27352,193222,71.35228951
11/15/2013,103231,62326,27378,192935,71.24630724
11/16/2013,102994,62212,27404,192610,71.12629247
11/17/2013,102743,62161,27434,192338,71.02584934
11/18/2013,102601,62161,27507,192269,71.00036928
11/19/2013,102414,62224,27638,192276,71.00295421
11/20/2013,102210,62224,27701,192135,70.95088626
11/21/2013,101961,62212,27745,191918,70.87075332
11/22/2013,101680,62173,27813,191666,70.77769572
11/23/2013,101523,62148,27688,191359,70.66432792
11/24/2013,101273,62072,27559,190904,70.49630724
11/25/2013,101070,61830,27567,190467,70.33493353
11/26/2013,100823,61613,27576,190012,70.16691285
11/27/2013,101538,62072,27805,191415,70.68500739
11/28/2013,102932,64147,28637,195716,72.2732644
11/29/2013,103594,65243,28964,197801,73.04320532
11/30/2013,104019,66019,29133,199171,73.54911374
12/1/2013,104288,66579,29275,200142,73.90768095
12/2/2013,104479,67037,29387,200903,74.18870015
12/3/2013,104606,67437,29509,201552,74.42836041
12/4/2013,104685,67808,29575,202068,74.61890694
12/5/2013,104827,68351,29661,202839,74.90361891
12/6/2013,105050,68987,29810,203847,75.27584934
12/7/2013,105288,69582,30009,204879,75.65694239
12/8/2013,105352,69953,30146,205451,75.86816839
12/9/2013,105304,70311,30273,205888,76.0295421
12/10/2013,105241,70550,30350,206141,76.12296898
12/11/2013,105209,70656,30401,206266,76.16912851
12/12/2013,105399,70669,30442,206510,76.25923191
12/13/2013,105446,70523,30401,206370,76.20753323
12/14/2013,105383,70523,30346,206252,76.16395864
12/15/2013,105336,70602,30442,206380,76.211226
12/16/2013,105241,70629,30487,206357,76.20273264
12/17/2013,105446,70430,30510,206386,76.21344165
12/18/2013,105320,70271,30433,206024,76.07976366
12/19/2013,105209,70245,30355,205809,76.00036928
12/20/2013,105066,70338,30255,205659,75.94497784
12/21/2013,105002,70616,30204,205822,76.00516987
12/22/2013,106596,72483,30447,209526,77.37296898
12/23/2013,108813,75542,31113,215468,79.56720827
12/24/2013,110582,77572,31765,219919,81.21085672
12/25/2013,111628,78885,31981,222494,82.16174298
12/26/2013,112299,79755,32169,224223,82.80022157
12/27/2013,112843,80613,32173,225629,83.31942393
12/28/2013,113453,81062,32184,226699,83.71454948
12/29/2013,114047,81308,32321,227676,84.07533235
12/30/2013,115426,82189,32667,230282,85.03766617
12/31/2013,116311,83013,32824,232148,85.7267356
1/1/2014,116763,83634,32781,233178,86.1070901
1/2/2014,117064,84154,32866,234084,86.44165436
1/3/2014,117283,84516,32771,234570,86.6211226
1/4/2014,117400,84646,32647,234693,86.66654357
1/5/2014,117602,84704,32705,235011,86.78397341
1/6/2014,118293,85109,32866,236268,87.24815362
1/7/2014,120684,87565,33553,241802,89.29172821
1/8/2014,121591,88057,33403,243051,89.75295421
1/9/2014,122275,88587,33221,244083,90.13404727
1/10/2014,123050,89165,32933,245148,90.52732644
1/11/2014,123876,89712,32943,246531,91.03803545
1/12/2014,126516,91736,34468,252720,93.32348597
1/13/2014,128146,92618,34931,255695,94.42208272
1/14/2014,129183,93090,34936,257209,94.98116691
1/15/2014,130334,93987,34966,259287,95.7485229
1/16/2014,131043,94474,34892,260409,96.16285081
1/17/2014,131737,94763,34655,261155,96.43833087
1/18/2014,132200,94869,34325,261394,96.52658789
1/19/2014,132487,94900,33988,261375,96.51957164
1/20/2014,132505,94763,33620,260888,96.33973412
1/21/2014,132361,94550,33254,260165,96.07274742
1/22/2014,132200,94109,32834,259143,95.69534712
1/23/2014,131773,93561,32377,257711,95.16654357
1/24/2014,131434,93014,31925,256373,94.67245199
1/25/2014,130830,92420,31658,254908,94.13146233
1/26/2014,130387,91842,31652,253881,93.75221566
1/27/2014,129855,91264,31545,252664,93.3028065
1/28/2014,129306,90670,31341,251317,92.80539143
1/29/2014,128743,90001,31141,249885,92.27658789
1/30/2014,128128,89332,31021,248481,91.75812408
1/31/2014,127618,88404,30877,246899,91.1739291
2/1/2014,127216,87652,30721,245589,90.69017725
2/2/2014,126883,87175,30762,244820,90.40620384
2/3/2014,126533,86698,30799,244030,90.11447563
2/4/2014,126097,86250,30657,243004,89.73559823
2/5/2014,125870,86005,30533,242408,89.5155096
2/6/2014,125835,85759,30538,242132,89.41358936
2/7/2014,125471,85499,30542,241512,89.18463811
2/8/2014,125140,85528,30227,240895,88.95679468
2/9/2014,124794,85557,30232,240583,88.8415805
2/10/2014,124447,85629,30259,240335,88.75
2/11/2014,124065,85672,29914,239651,88.49741507
2/12/2014,123670,85687,29571,238928,88.23042836
2/13/2014,123325,85701,29159,238185,87.95605613
2/14/2014,123187,85788,28879,237854,87.8338257
2/15/2014,122860,85788,28884,237532,87.71491876
2/16/2014,122584,85658,28778,237020,87.52584934
2/17/2014,122395,85369,28592,236356,87.28064993
2/18/2014,122104,85036,28451,235591,86.99815362
2/19/2014,121797,84501,28460,234758,86.69054653
2/20/2014,121609,84097,28469,234175,86.47525849
2/21/2014,121368,83793,28478,233639,86.27732644
2/22/2014,121436,83620,28526,233582,86.2562777
2/23/2014,121540,83692,28596,233828,86.34711965
2/24/2014,121557,83677,28623,233857,86.35782866
2/25/2014,121300,83533,28228,233061,86.06388479
2/26/2014,121043,83287,27831,232161,85.73153619
2/27/2014,120787,83027,27417,231231,85.38810931
2/28/2014,120480,82767,27048,230295,85.04246677
3/1/2014,120225,82406,26868,229499,84.7485229
3/2/2014,119936,82030,26864,228830,84.5014771
3/3/2014,119614,81683,26829,228126,84.24150665
3/4/2014,119325,81264,26578,227167,83.88737075
3/5/2014,119019,80861,26329,226209,83.53360414
3/6/2014,118613,80474,26068,225155,83.144387
3/7/2014,118293,79811,25809,223913,82.68574594
3/8/2014,117956,79134,25562,222652,82.22008863
3/9/2014,117686,78774,25557,222017,81.98559823
3/10/2014,117350,78360,25545,221255,81.70420975
3/11/2014,117031,78097,25345,220473,81.41543575
3/12/2014,116880,78097,25197,220174,81.30502216
3/13/2014,116981,78650,25027,220658,81.48375185
3/14/2014,116930,78968,24789,220687,81.49446086
3/15/2014,116863,79065,24625,220553,81.44497784
3/16/2014,116830,79258,24649,220737,81.51292467
3/17/2014,116730,79341,24670,220741,81.51440177
3/18/2014,116511,79355,24686,220552,81.44460857
3/19/2014,116227,79410,24670,220307,81.35413589
3/20/2014,116110,79424,24719,220253,81.33419498
3/21/2014,116093,79590,24780,220463,81.41174298
3/22/2014,116060,79755,24826,220641,81.47747415
3/23/2014,115993,79811,24879,220683,81.49298375
3/24/2014,115959,79880,24924,220763,81.52252585
3/25/2014,115809,79880,24949,220638,81.47636632
3/26/2014,116076,79838,24981,220895,81.57127031
3/27/2014,115993,79797,24998,220788,81.53175775
3/28/2014,115826,79755,25023,220604,81.46381093
3/29/2014,116194,80253,25097,221544,81.81093058
3/30/2014,118107,81698,25470,225275,83.18870015
3/31/2014,121009,84617,26257,231883,85.6288774
4/1/2014,122756,86525,26684,235965,87.13626292
4/2/2014,124153,87898,27060,239111,88.29800591
4/3/2014,125539,89073,27430,242042,89.38035451
4/4/2014,126831,90153,27844,244828,90.40915805
4/5/2014,128146,91127,28207,247480,91.38847858
4/6/2014,129430,92329,28508,250267,92.4176514
4/7/2014,130475,93227,28650,252352,93.18759232
4/8/2014,131363,93561,29057,253981,93.78914328
4/9/2014,132219,93637,29616,255472,94.33973412
4/10/2014,133096,93744,29995,256835,94.84305761
4/11/2014,133815,93744,30324,257883,95.23005908
4/12/2014,134750,93866,30762,259378,95.78212703
4/13/2014,135421,93987,31132,260540,96.211226
4/14/2014,136073,93972,31512,261557,96.58677991
4/15/2014,136763,93911,31873,262547,96.95236337
4/16/2014,140301,96350,32848,269499,99.51957164
4/17/2014,141580,97637,33062,272279,100.5461595
4/18/2014,141709,97878,33005,272592,100.661743
4/19/2014,141468,97701,32958,272127,100.4900295
4/20/2014,141209,97412,32871,271492,100.2555391
4/21/2014,140968,97058,32762,270788,99.99556869
4/22/2014,140634,96671,32624,269929,99.67836041
4/23/2014,140431,96382,32757,269570,99.54579025
4/24/2014,140153,96060,32876,269089,99.36816839
4/25/2014,139785,95554,32972,268311,99.08087149
4/26/2014,139455,95250,33081,267786,98.88700148
4/27/2014,139124,95219,33201,267544,98.79763663
4/28/2014,138958,95143,33288,267389,98.74039882
4/29/2014,138737,94946,33369,267052,98.61595273
4/30/2014,138461,94900,33461,266822,98.5310192
5/1/2014,138719,95037,33929,267685,98.84970458
5/2/2014,139252,95265,34281,268798,99.26070901
5/3/2014,139675,95371,34321,269367,99.47082718
5/4/2014,140264,95478,34330,270072,99.73116691
5/5/2014,140671,95539,34306,270516,99.89512555
5/6/2014,140690,95676,34286,270652,99.94534712
5/7/2014,140542,95867,34253,270662,99.94903988
5/8/2014,140486,95980,34330,270796,99.9985229
5/9/2014,140449,96205,34301,270955,100.0572378
5/10/2014,140468,96317,34276,271061,100.0963811
5/11/2014,140357,96462,34384,271203,100.1488183
5/12/2014,140227,96462,34492,271181,100.1406942
5/13/2014,140024,96414,34404,270842,100.0155096
5/14/2014,139877,96269,34340,270486,99.88404727
5/15/2014,139840,96157,34194,270191,99.77511078
5/16/2014,139712,95996,34121,269829,99.64143279
5/17/2014,141506,99166,35254,275926,101.8929099
5/18/2014,141894,99890,35244,277028,102.2998523
5/19/2014,141580,99441,35041,276062,101.9431315
5/20/2014,141320,98957,34976,275253,101.644387
5/21/2014,141005,98426,35021,274452,101.3485968
5/22/2014,140727,97943,35095,273765,101.094904
5/23/2014,140727,97734,35135,273596,101.0324963
5/24/2014,140616,97508,35110,273234,100.8988183
5/25/2014,140708,97170,35105,272983,100.80613
5/26/2014,140653,96832,35070,272555,100.6480798
5/27/2014,140616,96494,35045,272155,100.5003693
5/28/2014,140431,96269,35016,271716,100.338257
5/29/2014,140153,95996,34966,271115,100.116322
5/30/2014,139914,95691,34892,270497,99.88810931
5/31/2014,139822,95417,34853,270092,99.73855244
6/1/2014,139693,95113,34828,269634,99.56942393
6/2/2014,139509,94748,34833,269090,99.36853767
6/3/2014,139345,94322,34837,268504,99.1521418
6/4/2014,139345,94276,34715,268336,99.0901034
6/5/2014,139252,94139,34759,268150,99.02141802
6/6/2014,139032,93744,34616,267392,98.74150665
6/7/2014,138848,93364,34621,266833,98.53508124
6/8/2014,138627,92938,34626,266191,98.29800591
6/9/2014,138443,92527,34660,265630,98.09084195
6/10/2014,138241,92131,34675,265047,97.87555391
6/11/2014,138058,91736,34562,264356,97.62038405
6/12/2014,137857,91325,34587,263769,97.40361891
6/13/2014,137730,91401,34306,263437,97.2810192
6/14/2014,138369,92390,34873,265632,98.0915805
6/15/2014,138811,93090,34803,266704,98.48744461
6/16/2014,139124,93303,34621,267048,98.61447563
6/17/2014,139087,93394,34448,266929,98.57053176
6/18/2014,138976,93759,34321,267056,98.61742984
6/19/2014,138885,94094,34276,267255,98.69091581
6/20/2014,138866,94170,34267,267303,98.70864106
6/21/2014,138682,94109,34291,267082,98.62703102
6/22/2014,138461,93866,34325,266652,98.46824225
6/23/2014,138168,93577,34345,266090,98.26070901
6/24/2014,137875,93455,34257,265587,98.07496307
6/25/2014,137893,93364,34047,265304,97.9704579
6/26/2014,141580,93759,34281,269620,99.56425406
6/27/2014,141727,94368,34340,270435,99.86521418
6/28/2014,141246,94413,34443,270102,99.7422452
6/29/2014,140857,94307,34492,269656,99.57754801
6/30/2014,140597,94352,34533,269482,99.51329394
7/1/2014,140468,94413,34577,269458,99.50443131
7/2/2014,140209,94444,34492,269145,99.38884786
7/3/2014,140116,94459,34582,269157,99.39327917
7/4/2014,140431,94596,34557,269584,99.55096012
7/5/2014,140653,94611,34591,269855,99.65103397
7/6/2014,140523,94550,34513,269586,99.55169867
7/7/2014,140264,94428,34414,269106,99.37444609
7/8/2014,139822,94246,34243,268311,99.08087149
7/9/2014,139509,94200,34096,267805,98.89401773
7/10/2014,139124,94139,34062,267325,98.71676514
7/11/2014,138645,93713,34096,266454,98.39512555
7/12/2014,138076,93485,34106,265667,98.10450517
7/13/2014,137601,93029,34101,264731,97.75886263
7/14/2014,138040,92968,34863,265871,98.17983752
7/15/2014,138388,92831,34996,266215,98.30686854
7/16/2014,138829,92786,35329,266944,98.5760709
7/17/2014,139068,92694,35130,266892,98.55686854
7/18/2014,139105,92527,35070,266702,98.48670606
7/19/2014,139087,92329,35060,266476,98.40324963
7/20/2014,138682,92070,35041,265793,98.15103397
7/21/2014,138205,91827,35016,265048,97.87592319
7/22/2014,137730,91583,35001,264314,97.60487445
7/23/2014,136981,91309,34863,263153,97.17614476
7/24/2014,136690,91279,34749,262718,97.0155096
7/25/2014,136091,91036,34734,261861,96.69903988
7/26/2014,135475,90594,34710,260779,96.29948301
7/27/2014,134877,90275,34680,259832,95.94977843
7/28/2014,134426,90093,34680,259199,95.71602659
7/29/2014,133977,89712,34650,258339,95.39844904
7/30/2014,133437,89530,34591,257558,95.11004431
7/31/2014,132826,89073,34547,256446,94.69940916
8/1/2014,132344,88526,34497,255367,94.30096012
8/2/2014,131987,88237,34473,254697,94.05354505
8/3/2014,131576,87970,34419,253965,93.78323486
8/4/2014,131185,87710,34345,253240,93.5155096
8/5/2014,130777,87421,34281,252479,93.2344904
8/6/2014,130369,87204,34101,251674,92.93722304
8/7/2014,129925,86886,34018,250829,92.62518464
8/8/2014,129501,86409,33939,249849,92.26329394
8/9/2014,129042,85875,33853,248770,91.8648449
8/10/2014,128585,85340,33780,247705,91.47156573
8/11/2014,128110,84964,33698,246772,91.12703102
8/12/2014,127653,84617,33465,245735,90.74409158
8/13/2014,127547,84342,33427,245316,90.58936484
8/14/2014,127163,84053,33369,244585,90.31942393
8/15/2014,126726,83490,33302,243518,89.9254062
8/16/2014,126236,82854,33235,242325,89.48485968
8/17/2014,125747,82232,33163,241142,89.04800591
8/18/2014,125278,81582,33101,239961,88.61189069
8/19/2014,124759,80888,32890,238537,88.08604136
8/20/2014,124291,80419,32657,237367,87.65398818
8/21/2014,123825,80060,32430,236315,87.2655096
8/22/2014,123376,79686,32396,235458,86.94903988
8/23/2014,122912,79272,32330,234514,86.60044313
8/24/2014,122464,78996,32264,233724,86.30871492
8/25/2014,121968,78664,32189,232821,85.97525849
8/26/2014,121522,78332,31990,231844,85.61447563
8/27/2014,120975,78001,31771,230747,85.20937962
8/28/2014,120463,77655,31541,229659,84.80760709
8/29/2014,120004,77310,31211,228525,84.38884786
8/30/2014,119512,76923,30850,227285,83.93094535
8/31/2014,119019,76468,30501,225988,83.45199409
9/1/2014,118579,76122,30164,224865,83.0372969
9/2/2014,118090,75887,29823,223800,82.64401773
9/3/2014,117719,75555,29509,222783,82.26846381
9/4/2014,117132,75265,29181,221578,81.82348597
9/5/2014,116663,75058,28959,220680,81.49187592
9/6/2014,116177,74837,28769,219783,81.16063516
9/7/2014,115709,74602,28738,219049,80.88958641
9/8/2014,115210,74368,28694,218272,80.60265879
9/9/2014,114694,74022,28504,217220,80.21418021
9/10/2014,114180,73569,28315,216064,79.7872969
9/11/2014,113683,73092,28158,214933,79.36964549
9/12/2014,113206,72311,28105,213622,78.88552437
9/13/2014,112728,71437,28071,212236,78.37370753
9/14/2014,112250,70497,28049,210796,77.84194978
9/15/2014,111792,69596,28005,209393,77.32385524
9/16/2014,111301,68854,27957,208112,76.85081241
9/17/2014,110794,68139,27909,206842,76.38183161
9/18/2014,110306,67241,27862,205409,75.85265879
9/19/2014,109916,66528,27809,204253,75.42577548
9/20/2014,109396,65599,27757,202752,74.87149188
9/21/2014,108895,64619,27719,201233,74.3105613
9/22/2014,108443,63701,27658,199802,73.78212703
9/23/2014,107991,62810,27606,198407,73.26698671
9/24/2014,107525,61906,27554,196985,72.74187592
9/25/2014,107060,61218,27507,195785,72.29874446
9/26/2014,106612,60781,27442,194835,71.94793205
9/27/2014,106100,59987,27395,193482,71.44830133
9/28/2014,105605,59059,27339,192003,70.9021418
9/29/2014,105145,58070,27288,190503,70.34822747
9/30/2014,104669,56971,27227,188867,69.74409158
10/1/2014,104192,55933,27176,187301,69.16580502
10/2/2014,103704,55030,27141,185875,68.63921713
10/3/2014,103215,54217,27111,184543,68.14734121
10/4/2014,102727,53517,27090,183334,67.70088626
10/5/2014,102383,52910,27107,182400,67.35598227
10/6/2014,101945,52071,27090,181106,66.87813885
10/7/2014,101492,51138,27064,179694,66.35672083
10/8/2014,101086,50227,27039,178352,65.86115214
10/9/2014,100683,49609,27026,177318,65.47932053
10/10/2014,100234,48892,27009,176135,65.04246677
10/11/2014,99784,48147,26988,174919,64.59342688
10/12/2014,99351,47469,26962,173782,64.17355982
10/13/2014,98936,46824,26923,172683,63.76772526
10/14/2014,98491,46124,26897,171512,63.33530281
10/15/2014,98061,45412,26872,170345,62.90435746
10/16/2014,97908,45701,26919,170528,62.97193501
10/17/2014,97709,46435,27077,171221,63.22784343
10/18/2014,97725,46713,27102,171540,63.34564254
10/19/2014,97740,46880,27107,171727,63.41469719
10/20/2014,97725,46980,27094,171799,63.44128508
10/21/2014,97298,47046,27081,171425,63.30317578
10/22/2014,96825,47147,27090,171062,63.16912851
10/23/2014,96400,47236,26936,170572,62.98818316
10/24/2014,96295,47525,26846,170666,63.02289513
10/25/2014,96053,47869,26651,170573,62.98855244
10/26/2014,95720,48136,26427,170283,62.88146233
10/27/2014,95373,48381,26169,169923,62.7485229
10/28/2014,95040,48603,25913,169556,62.61299852
10/29/2014,94755,48804,25650,169209,62.48485968
10/30/2014,94366,48970,25379,168715,62.30243722
10/31/2014,93976,49119,25106,168201,62.11262925
11/1/2014,93572,49212,24822,167606,61.8929099
11/2/2014,93110,49142,24523,166775,61.58604136
11/3/2014,92709,49060,24242,166011,61.30391433
11/4/2014,92279,48937,23963,165179,60.99667651
11/5/2014,91792,48815,23653,164260,60.65731167
11/6/2014,91394,48848,23385,163627,60.42355982
11/7/2014,90908,48603,23187,162698,60.08050222
11/8/2014,90614,48303,23004,161921,59.79357459
11/9/2014,90233,47880,22818,160931,59.42799114
11/10/2014,89884,47436,22630,159950,59.06573117
11/11/2014,89491,46924,22431,158846,58.65805022
11/12/2014,89257,46379,22427,158063,58.36890694
11/13/2014,88980,45801,22408,157189,58.04615953
11/14/2014,88720,45312,22408,156440,57.76957164
11/15/2014,88460,44934,22400,155794,57.5310192
11/16/2014,88172,44567,22392,155131,57.28618907
11/17/2014,87955,44189,22392,154536,57.06646972
11/18/2014,87869,43888,22501,154258,56.96381093
11/19/2014,87739,43644,22568,153951,56.85044313
11/20/2014,87466,43372,22595,153433,56.65915805
11/21/2014,87352,43277,22611,153240,56.58788774
11/22/2014,87037,42930,22615,152582,56.34490399
11/23/2014,86708,42584,22630,151922,56.10118168
11/24/2014,86523,42542,22665,151730,56.03028065
11/25/2014,86580,42783,22969,152332,56.25258493
11/26/2014,86508,43004,23100,152612,56.35598227
11/27/2014,86737,43435,23195,153367,56.63478582
11/28/2014,87066,43911,23286,154263,56.96565731
11/29/2014,87138,44089,23346,154573,57.08013294
11/30/2014,86980,44166,23401,154547,57.07053176
12/1/2014,86737,44255,23465,154457,57.0372969
12/2/2014,86637,44622,23557,154816,57.16986706
12/3/2014,86523,44867,23609,154999,57.23744461
12/4/2014,86551,45145,23721,155417,57.39180207
12/5/2014,86508,45356,23838,155702,57.49704579
12/6/2014,86451,45556,23938,155945,57.58677991
12/7/2014,86680,46112,24246,157038,57.99039882
12/8/2014,86751,46591,24434,157776,58.26292467
12/9/2014,86923,46980,24568,158471,58.51957164
12/10/2014,87281,47580,24817,159678,58.96528804
12/11/2014,87509,48092,24924,160525,59.27806499
12/12/2014,87710,48470,25047,161227,59.5372969
12/13/2014,87811,48726,25147,161684,59.70605613
12/14/2014,88129,48915,25234,162278,59.9254062
12/15/2014,88474,49084,25308,162866,60.14254062
12/16/2014,88489,49235,25391,163115,60.2344904
12/17/2014,88518,49410,25491,163419,60.34675037
12/18/2014,88778,49959,25574,164311,60.67614476
12/19/2014,88907,50391,25658,164956,60.91432792
12/20/2014,89009,50683,25725,165417,61.08456425
12/21/2014,89374,50928,25796,166098,61.33604136
12/22/2014,89723,51126,25879,166728,61.56868538
12/23/2014,89826,51313,25955,167094,61.70384047
12/24/2014,90103,51639,26005,167747,61.94497784
12/25/2014,90790,52747,26714,170251,62.86964549
12/26/2014,92234,54101,27378,173713,64.14807976
12/27/2014,93303,55140,27679,176122,65.03766617
12/28/2014,94276,56031,27905,178212,65.80945347
12/29/2014,95161,56971,28114,180246,66.5605613
12/30/2014,95856,57618,28285,181759,67.11927622
12/31/2014,96234,58094,28416,182744,67.48301329
1/1/2015,96506,58412,28429,183347,67.70568685
1/2/2015,96992,58668,28530,184190,68.01698671
1/3/2015,97404,58900,28632,184936,68.29246677
1/4/2015,97938,59242,28786,185966,68.67282127
1/5/2015,98844,60158,29128,188130,69.47193501
1/6/2015,99428,60671,29279,189378,69.93279173
1/7/2015,99583,60976,29208,189767,70.07644018
1/8/2015,99753,61142,29114,190009,70.16580502
1/9/2015,99939,61218,29008,190165,70.22341211
1/10/2015,100125,61333,28911,190369,70.29874446
1/11/2015,100466,61396,28985,190847,70.47525849
1/12/2015,100823,61473,29088,191384,70.67355982
1/13/2015,100978,61613,29066,191657,70.77437223
1/14/2015,101024,61613,28999,191636,70.76661743
1/15/2015,101055,61562,28911,191528,70.7267356
1/16/2015,101086,61536,28839,191461,70.70199409
1/17/2015,101086,61498,28738,191322,70.6506647
1/18/2015,101273,61384,28791,191448,70.6971935
1/19/2015,101554,61307,28906,191767,70.81499261
1/20/2015,101773,61243,28981,191997,70.89992614
1/21/2015,101758,61154,28888,191800,70.82717873
1/22/2015,101695,60976,28756,191427,70.6894387
1/23/2015,101648,60829,28663,191140,70.58345643
1/24/2015,101586,60671,28561,190818,70.46454948
1/25/2015,101695,60512,28614,190821,70.46565731
1/26/2015,101804,60366,28641,190811,70.46196455
1/27/2015,101570,60170,28416,190156,70.22008863
1/28/2015,101367,59950,28285,189602,70.0155096
1/29/2015,101133,59731,28110,188974,69.78360414
1/30/2015,100900,59535,28009,188444,69.58788774
1/31/2015,100853,59352,27909,188114,69.46602659
2/1/2015,100884,59120,27927,187931,69.39844904
2/2/2015,101070,58986,27974,188030,69.43500739
2/3/2015,100915,58778,27857,187550,69.2577548
2/4/2015,100823,58546,27736,187105,69.09342688
2/5/2015,100730,58351,27619,186700,68.94387001
2/6/2015,100606,58131,27507,186244,68.77548006
2/7/2015,100466,57899,27369,185734,68.58714919
2/8/2015,100528,57679,27395,185602,68.53840473
2/9/2015,100636,57496,27438,185570,68.52658789
2/10/2015,100528,57301,27318,185147,68.37038405
2/11/2015,100342,57069,27197,184608,68.17134417
2/12/2015,100001,56837,26957,183795,67.8711226
2/13/2015,99706,56886,26757,183349,67.70642541
2/14/2015,99397,56800,26549,182746,67.48375185
2/15/2015,99060,56861,26350,182271,67.30834564
2/16/2015,98659,56922,26131,181712,67.10192024
2/17/2015,98352,56812,25934,181098,66.87518464
2/18/2015,98014,56886,25754,180654,66.711226
2/19/2015,97694,56934,25595,180223,66.55206795
2/20/2015,97343,56825,25354,179522,66.29320532
2/21/2015,96992,56703,25101,178796,66.02511078
2/22/2015,96856,56751,25114,178721,65.99741507
2/23/2015,96871,56800,25114,178785,66.02104874
2/24/2015,96567,56690,24891,178148,65.78581979
2/25/2015,96144,56532,24649,177325,65.48190547
2/26/2015,95735,56544,24426,176705,65.25295421
2/27/2015,95342,56361,24201,175904,64.95716396
2/28/2015,94980,56141,23983,175104,64.66174298
3/1/2015,94725,56116,23785,174626,64.48522895
3/2/2015,94725,56129,23790,174644,64.49187592
3/3/2015,94351,55970,23585,173906,64.21935007
3/4/2015,94036,55799,23405,173240,63.97341211
3/5/2015,93662,55579,23199,172440,63.67799114
3/6/2015,93288,55372,23000,171660,63.38995569
3/7/2015,92917,55274,22795,170986,63.14106352
3/8/2015,92531,55262,22591,170384,62.91875923
3/9/2015,92531,55250,22575,170356,62.9084195
3/10/2015,92175,55079,22373,169627,62.63921713
3/11/2015,91777,55018,22190,168985,62.4021418
3/12/2015,91570,55176,22058,168804,62.33530281
3/13/2015,91394,55237,21919,168550,62.24150665
3/14/2015,91555,55225,21953,168733,62.30908419
3/15/2015,91762,55140,22000,168902,62.37149188
3/16/2015,91968,55115,22035,169118,62.45125554
3/17/2015,92234,55066,22073,169373,62.54542097
3/18/2015,92576,55152,22128,169856,62.72378139
3/19/2015,92858,55201,22132,170191,62.84748892
3/20/2015,93155,55201,22182,170538,62.97562777
3/21/2015,93422,55237,22225,170884,63.10339734
3/22/2015,93662,55274,22256,171192,63.21713442
3/23/2015,93841,55274,22275,171390,63.29025111
3/24/2015,94051,55286,22295,171632,63.37961595
3/25/2015,94231,55274,22291,171796,63.44017725
3/26/2015,94516,55298,22314,172128,63.56277696
3/27/2015,94980,55713,22380,173073,63.91174298
3/28/2015,95222,56300,22439,173961,64.23966027
3/29/2015,95463,56580,22482,174525,64.44793205
3/30/2015,95659,56825,22529,175013,64.62813885
3/31/2015,95917,57069,22568,175554,64.82791728
4/1/2015,96234,57276,22579,176089,65.02548006
4/2/2015,96598,57460,22615,176673,65.24113737
4/3/2015,97450,58278,22713,178441,65.89401773
4/4/2015,99490,61231,23044,183765,67.86004431
4/5/2015,101961,64899,23493,190353,70.29283604
4/6/2015,103594,67165,23769,194528,71.83456425
4/7/2015,105225,69265,24088,198578,73.33013294
4/8/2015,107124,71795,24633,203552,75.16691285
4/9/2015,109965,75086,25209,210260,77.64401773
4/10/2015,112794,78871,25725,217390,80.27695716
4/11/2015,116009,83013,26757,225779,83.37481536
4/12/2015,118731,85889,27382,232002,85.67282127
4/13/2015,120633,87695,27949,236277,87.2514771
4/14/2015,122190,89149,28628,239967,88.61410635
4/15/2015,123670,90397,29369,243436,89.89512555
4/16/2015,124794,91264,29832,245890,90.80132939
4/17/2015,125905,91918,30213,248036,91.59379616
4/18/2015,126848,92466,30639,249953,92.30169867
4/19/2015,127565,92847,30980,251392,92.83308715
4/20/2015,128357,93105,31243,252705,93.31794682
4/21/2015,129288,93516,31620,254424,93.95273264
4/22/2015,130280,94322,32094,256696,94.79172821
4/23/2015,131256,94900,32410,258566,95.48227474
4/24/2015,132076,95402,32686,260164,96.07237814
4/25/2015,132862,95754,32881,261497,96.56462334
4/26/2015,133527,96012,33062,262601,96.97230428
4/27/2015,134120,96173,33221,263514,97.30945347
4/28/2015,134678,96253,33360,264291,97.59638109
4/29/2015,135058,96237,33480,264775,97.77511078
4/30/2015,135493,96173,33582,265248,97.94977843
5/1/2015,135928,96044,33684,265656,98.10044313
5/2/2015,136181,95867,33765,265813,98.1584195
5/3/2015,136490,95660,33838,265988,98.22304284
5/4/2015,136672,95417,33920,266009,98.23079764
5/5/2015,136836,95143,33988,265967,98.21528804
5/6/2015,137018,94854,34037,265909,98.19387001
5/7/2015,137181,94565,34096,265842,98.16912851
5/8/2015,137401,94413,34106,265920,98.19793205
5/9/2015,137528,94261,34199,265988,98.22304284
5/10/2015,137730,94063,34238,266031,98.23892171
5/11/2015,137820,93881,34281,265982,98.22082718
5/12/2015,137857,93653,34316,265826,98.16322009
5/13/2015,137839,93409,34350,265598,98.07902511
5/14/2015,137893,93196,34301,265390,98.00221566
5/15/2015,137784,92923,34316,265023,97.86669129
5/16/2015,137657,92694,34374,264725,97.75664697
5/17/2015,137547,92573,34438,264558,97.69497784
5/18/2015,137401,92299,34453,264153,97.54542097
5/19/2015,137218,92147,34478,263843,97.43094535
5/20/2015,136908,91903,34492,263303,97.23153619
5/21/2015,136617,91690,34513,262820,97.05317578
5/22/2015,136272,91477,34296,262045,96.76698671
5/23/2015,135946,91248,34243,261437,96.54246677
5/24/2015,135602,91005,34243,260850,96.32570162
5/25/2015,135239,90762,34238,260239,96.10007386
5/26/2015,134877,90503,34233,259613,95.86890694
5/27/2015,134498,90458,33969,258925,95.6148449
5/28/2015,134372,90458,33906,258736,95.5450517
5/29/2015,134048,90442,33717,258207,95.34970458
5/30/2015,133671,90229,33475,257375,95.04246677
5/31/2015,133419,89986,33499,256904,94.86853767
6/1/2015,133186,89925,33630,256741,94.80834564
6/2/2015,133329,89925,33843,257097,94.93980798
6/3/2015,133132,89940,33504,256576,94.74741507
6/4/2015,132916,89910,33596,256422,94.69054653
6/5/2015,132611,89849,33273,255733,94.43611521
6/6/2015,132255,89788,33297,255340,94.29098966
6/7/2015,131933,89499,33389,254821,94.0993353
6/8/2015,131541,89180,33470,254191,93.86669129
6/9/2015,131844,89226,33529,254599,94.01735598
6/10/2015,132255,89271,33509,255035,94.17836041
6/11/2015,132434,89058,33558,255050,94.18389956
6/12/2015,132344,88784,33441,254569,94.0062777
6/13/2015,132379,88572,33360,254311,93.91100443
6/14/2015,132416,88359,33475,254250,93.88847858
6/15/2015,133258,88906,33620,255784,94.4549483
6/16/2015,134678,90062,33876,258616,95.50073855
6/17/2015,135258,90777,33819,259854,95.95790251
6/18/2015,135711,91203,33736,260650,96.25184638
6/19/2015,136091,91553,33639,261283,96.48559823
6/20/2015,136399,91614,33596,261609,96.60598227
6/21/2015,136836,91659,33833,262328,96.87149188
6/22/2015,137875,92223,34582,264680,97.74002954
6/23/2015,138737,92679,34552,265968,98.21565731
6/24/2015,139124,92999,34596,266719,98.49298375
6/25/2015,139400,93196,34503,267099,98.63330871
6/26/2015,139436,93303,34587,267326,98.71713442
6/27/2015,139363,93379,34725,267467,98.76920236
6/28/2015,139363,93516,34966,267845,98.90878877
6/29/2015,139564,93850,35160,268574,99.17799114
6/30/2015,139785,94155,35095,269035,99.34822747
7/1/2015,140209,95706,35140,271055,100.0941654
7/2/2015,140394,97605,35135,273134,100.8618907
7/3/2015,140301,97943,34971,273215,100.8918021
7/4/2015,140190,97492,34823,272505,100.629616
7/5/2015,140098,97106,34710,271914,100.4113737
7/6/2015,139859,96623,34552,271034,100.0864106
7/7/2015,139564,96173,34404,270141,99.75664697
7/8/2015,139271,95508,34468,269247,99.42651403
7/9/2015,138903,94930,34528,268361,99.0993353
7/10/2015,138811,94733,34538,268082,98.99630724
7/11/2015,138553,94763,34538,267854,98.91211226
7/12/2015,138058,94504,34591,267153,98.65324963
7/13/2015,137565,94276,34606,266447,98.39254062
7/14/2015,137036,93790,34523,265349,97.98707533
7/15/2015,136763,93166,34562,264491,97.67023634
7/16/2015,136617,92040,34582,263239,97.20790251
7/17/2015,136417,90838,34473,261728,96.64992614
7/18/2015,136055,89591,34365,260011,96.01587888
7/19/2015,135982,88389,34365,258736,95.5450517
7/20/2015,135819,87334,34365,257518,95.09527326
7/21/2015,135493,86178,34155,255826,94.4704579
7/22/2015,135185,84993,33993,254171,93.85930576
7/23/2015,134678,83721,33824,252223,93.13995569
7/24/2015,134192,82463,33644,250299,92.42946824
7/25/2015,133743,81105,33437,248285,91.68574594
7/26/2015,133473,79908,33379,246760,91.1225997
7/27/2015,133509,78747,33465,245721,90.73892171
7/28/2015,133455,77545,33437,244437,90.26477105
7/29/2015,133293,76260,33331,242884,89.69128508
7/30/2015,133060,74975,33120,241155,89.0528065
7/31/2015,132934,73821,33067,239822,88.5605613
8/1/2015,132629,72602,32933,238164,87.94830133
8/2/2015,132434,71238,32895,236567,87.35856721
8/3/2015,132200,70576,32857,235633,87.01366322
8/4/2015,131719,70099,32742,234560,86.61742984
8/5/2015,131238,69768,32605,233611,86.26698671
8/6/2015,130688,69530,32425,232643,85.90952733
8/7/2015,130209,69278,32250,231737,85.57496307
8/8/2015,129642,69013,32056,230711,85.19608567
8/9/2015,129077,68722,32014,229813,84.86447563
8/10/2015,128549,68470,31962,228981,84.55723781
8/11/2015,128146,68430,31850,228426,84.35228951
8/12/2015,127794,68338,31855,227987,84.19017725
8/13/2015,127337,68192,31855,227384,83.96750369
8/14/2015,126883,68007,31826,226716,83.72082718
8/15/2015,126359,67768,31648,225775,83.37333826
8/16/2015,125870,67543,31606,225019,83.09416544
8/17/2015,125331,67397,31565,224293,82.8260709
8/18/2015,124777,67190,31373,223340,82.47415066
8/19/2015,124291,66961,31183,222435,82.13995569
8/20/2015,123739,66732,30993,221464,81.78138848
8/21/2015,123566,66656,30919,221141,81.66211226
8/22/2015,123273,66643,30841,220757,81.52031019
8/23/2015,122791,66528,30818,220137,81.29135894
8/24/2015,122241,66337,30772,219350,81.00073855
8/25/2015,121848,66159,30607,218614,80.72895126
8/26/2015,121334,66134,30415,217883,80.45901034
8/27/2015,120838,66006,30364,217208,80.20974889
8/28/2015,120310,65828,30305,216443,79.92725258
8/29/2015,119784,65650,30105,215539,79.59342688
8/30/2015,119257,65421,30059,214737,79.29726736
8/31/2015,118731,65179,30004,213914,78.99335303
9/1/2015,118208,64912,29787,212907,78.62149188
9/2/2015,117669,64644,29625,211938,78.26366322
9/3/2015,117182,64377,29441,211000,77.91728213
9/4/2015,116713,64096,29261,210070,77.57385524
9/5/2015,116211,63713,29074,208998,77.17799114
9/6/2015,115742,63332,29035,208109,76.84970458
9/7/2015,115227,62899,28977,207103,76.4782127
9/8/2015,114761,62416,28804,205981,76.06388479
9/9/2015,114246,61893,28592,204731,75.60228951
9/10/2015,113881,61677,28434,203992,75.32939439
9/11/2015,113453,61575,28271,203299,75.07348597
9/12/2015,112975,61396,28236,202607,74.81794682
9/13/2015,112613,61256,28346,202215,74.67319055
9/14/2015,112152,61091,28455,201698,74.48227474
9/15/2015,111677,60964,28411,201052,74.2437223
9/16/2015,111186,60793,28241,200220,73.93648449
9/17/2015,110713,60622,28032,199367,73.62149188
9/18/2015,110241,60256,27849,198346,73.24446086
9/19/2015,109770,59633,27662,197065,72.77141802
9/20/2015,109299,59083,27619,196001,72.37850812
9/21/2015,108813,58473,27580,194866,71.95937962
9/22/2015,108347,57814,27528,193689,71.52474151
9/23/2015,107798,57166,27339,192303,71.01292467
9/24/2015,107412,56483,27150,191045,70.54837518
9/25/2015,106916,55713,26957,189586,70.00960118
9/26/2015,106404,54932,26769,188105,69.4627031
9/27/2015,105956,54171,26723,186850,68.99926145
9/28/2015,105446,53447,26676,185569,68.52621861
9/29/2015,105002,53074,26613,184689,68.20125554
9/30/2015,104970,53167,26574,184711,68.20937962
10/1/2015,105478,53681,26868,186027,68.69534712
10/2/2015,105589,53914,26966,186469,68.85856721
10/3/2015,105462,54042,27013,186517,68.87629247
10/4/2015,105257,54159,27039,186455,68.85339734
10/5/2015,105002,54206,27064,186272,68.78581979
10/6/2015,104717,53891,27073,185681,68.56757755
10/7/2015,104320,53436,27077,184833,68.25443131
10/8/2015,103893,52957,27056,183906,67.91211226
10/9/2015,103452,52432,26923,182807,67.5062777
10/10/2015,103152,52129,26791,182072,67.23485968
10/11/2015,102775,51896,26786,181457,67.0077548
10/12/2015,102383,51627,26774,180784,66.75923191
10/13/2015,101976,51289,26587,179852,66.41506647
10/14/2015,101507,50974,26401,178882,66.05686854
10/15/2015,101133,50589,26202,177924,65.70310192
10/16/2015,100823,50087,26160,177070,65.38774003
10/17/2015,100544,49562,26152,176258,65.08788774
10/18/2015,100544,48981,26135,175660,64.86706056
10/19/2015,100528,48414,26118,175060,64.64549483
10/20/2015,100450,47803,26102,174355,64.3851551
10/21/2015,100109,47336,26089,173534,64.08197932
10/22/2015,99784,46869,26072,172725,63.78323486
10/23/2015,99413,46390,26072,171875,63.46935007
10/24/2015,99106,45912,26064,171082,63.17651403
10/25/2015,98813,45501,26085,170399,62.92429838
10/26/2015,98537,45078,26106,169721,62.6739291
10/27/2015,98214,44956,26110,169280,62.51107829
10/28/2015,97786,44956,26118,168860,62.35598227
10/29/2015,98214,45512,26697,170423,62.933161
10/30/2015,98983,47080,27318,173381,64.02548006
10/31/2015,99182,47914,27524,174620,64.48301329
11/1/2015,99213,48570,27666,175449,64.78914328
11/2/2015,99167,49037,27809,176013,64.99741507
11/3/2015,99044,49469,27849,176362,65.12629247
11/4/2015,98890,49819,27879,176588,65.20974889
11/5/2015,98629,50111,27949,176689,65.24704579
11/6/2015,98399,50367,28014,176780,65.28064993
11/7/2015,98184,50589,28036,176809,65.29135894
11/8/2015,97908,50776,28080,176764,65.27474151
11/9/2015,97664,50951,28114,176729,65.26181684
11/10/2015,97282,51103,28171,176556,65.19793205
11/11/2015,97206,51884,28359,177449,65.52769572
11/12/2015,97359,53541,28866,179766,66.38330871
11/13/2015,97359,54556,29208,181123,66.88441654
11/14/2015,97359,55445,29482,182286,67.31388479
11/15/2015,97343,56177,29638,183158,67.63589365
11/16/2015,97282,56788,29792,183862,67.89586411
11/17/2015,97146,57313,29946,184405,68.09638109
11/18/2015,96962,57777,30064,184803,68.24335303
11/19/2015,96810,58168,30164,185142,68.36853767
11/20/2015,97084,58803,31174,187061,69.07717873
11/21/2015,97359,59462,31771,188592,69.64254062
11/22/2015,97389,59999,32085,189473,69.96787297
11/23/2015,97786,60439,32302,190527,70.3570901
11/24/2015,97923,60854,32468,191245,70.62223043
11/25/2015,97816,61218,32577,191611,70.75738552
11/26/2015,97832,61562,32681,192075,70.92872969
11/27/2015,97786,61855,32781,192422,71.05686854
11/28/2015,97740,62123,32890,192753,71.17909897
11/29/2015,97664,62377,32981,193022,71.27843427
11/30/2015,97556,62606,33077,193239,71.35856721
12/1/2015,97450,62848,33177,193475,71.4457164
12/2/2015,97328,63103,33297,193728,71.53914328
12/3/2015,97587,63447,33269,194303,71.7514771
12/4/2015,97816,63765,33240,194821,71.94276219
12/5/2015,98076,64033,33153,195262,72.105613
12/6/2015,98291,64287,33067,195645,72.24704579
12/7/2015,98475,64542,32972,195989,72.37407681
12/8/2015,98690,64759,32885,196334,72.5014771
12/9/2015,98598,64988,32767,196353,72.50849335
12/10/2015,98813,65192,32628,196633,72.61189069
12/11/2015,98998,65408,32505,196911,72.71454948
12/12/2015,99151,65586,32377,197114,72.78951256
12/13/2015,99290,65764,32245,197299,72.85782866
12/14/2015,99413,65955,32108,197476,72.92319055
12/15/2015,99753,66019,32056,197828,73.05317578
12/16/2015,100078,66286,32014,198378,73.2562777
12/17/2015,100280,66630,31914,198824,73.42097489
12/18/2015,100652,66707,32005,199364,73.62038405
12/19/2015,100993,66783,32009,199785,73.77584934
12/20/2015,101320,66821,32122,200263,73.95236337
12/21/2015,101680,66847,32245,200772,74.14032496
12/22/2015,102023,66885,32368,201276,74.32644018
12/23/2015,102570,67437,32519,202526,74.78803545
12/24/2015,103105,68020,32786,203911,75.29948301
12/25/2015,103767,68603,33048,205418,75.85598227
12/26/2015,104431,69066,33101,206598,76.29172821
12/27/2015,105002,69675,33057,207734,76.711226
12/28/2015,105621,70497,33005,209123,77.22415066
12/29/2015,106212,71291,32948,210451,77.71454948
12/30/2015,106580,72033,32862,211475,78.09268833
12/31/2015,107204,72960,32819,212983,78.64955687
1/1/2016,107863,73914,32834,214611,79.25073855
1/2/2016,108427,74740,32786,215953,79.74630724
1/3/2016,108959,75500,32723,217182,80.20014771
1/4/2016,109461,76163,32619,218243,80.59194978
1/5/2016,109754,76661,32444,218859,80.81942393
1/6/2016,109981,76992,32203,219176,80.93648449
1/7/2016,110192,77034,32085,219311,80.98633678
1/8/2016,110485,77075,31939,219499,81.05576071
1/9/2016,110794,77117,31914,219825,81.17614476
1/10/2016,111154,77255,32014,220423,81.39697194
1/11/2016,111824,78429,32552,222805,82.27658789
1/12/2016,112266,79231,32767,224264,82.81536189
1/13/2016,112415,79631,32714,224760,82.9985229
1/14/2016,112712,79894,32486,225092,83.1211226
1/15/2016,113189,80226,32363,225778,83.37444609
1/16/2016,113584,80543,32288,226415,83.60967504
1/17/2016,114113,80932,32231,227276,83.92762186
1/18/2016,114379,81221,32118,227718,84.09084195
1/19/2016,114495,81365,31986,227846,84.13810931
1/20/2016,114628,81568,31944,228140,84.24667651
1/21/2016,114828,81755,31881,228464,84.36632201
1/22/2016,114895,81828,31686,228409,84.34601182
1/23/2016,114828,81698,31560,228086,84.2267356
1/24/2016,114678,81597,31569,227844,84.13737075
1/25/2016,114545,81467,31578,227590,84.04357459
1/26/2016,114462,81322,31591,227375,83.96418021
1/27/2016,114379,81192,31600,227171,83.88884786
1/28/2016,114329,81091,31606,227026,83.83530281
1/29/2016,114246,80946,31582,226774,83.7422452
1/30/2016,114130,80778,31578,226486,83.63589365
1/31/2016,114031,80557,31569,226157,83.51440177
2/1/2016,113832,80378,31560,225770,83.37149188
2/2/2016,113733,80226,31555,225514,83.27695716
2/3/2016,113338,80074,31541,224953,83.06979321
2/4/2016,113535,80212,31813,225560,83.29394387
2/5/2016,113650,80350,31962,225962,83.44239291
2/6/2016,113848,80378,32014,226240,83.5450517
2/7/2016,114097,80378,32066,226541,83.65620384
2/8/2016,114379,80364,32099,226842,83.76735598
2/9/2016,114429,80364,32118,226911,83.79283604
2/10/2016,114412,80308,32131,226851,83.77067947
2/11/2016,114512,80253,32146,226911,83.79283604
2/12/2016,114545,80087,32066,226698,83.71418021
2/13/2016,114595,79866,31953,226414,83.60930576
2/14/2016,114446,79645,31667,225758,83.36706056
2/15/2016,114279,79341,31429,225049,83.10524372
2/16/2016,114462,79465,31429,225356,83.21861152
2/17/2016,116160,81365,32155,229680,84.81536189
2/18/2016,116964,82550,32368,231882,85.62850812
2/19/2016,117602,83302,32245,233149,86.09638109
2/20/2016,118175,83764,32122,234061,86.433161
2/21/2016,118681,84082,32222,234985,86.77437223
2/22/2016,119172,84342,32288,235802,87.0760709
2/23/2016,119580,84776,32349,236705,87.40952733
2/24/2016,119987,85167,32405,237559,87.72488922
2/25/2016,122464,86828,33620,242912,89.70162482
2/26/2016,125245,90458,34587,250290,92.42614476
2/27/2016,126777,91736,34720,253233,93.51292467
2/28/2016,127776,92405,34725,254906,94.13072378
2/29/2016,128479,92816,34675,255970,94.52363368
3/1/2016,128937,92999,34591,256527,94.72932053
3/2/2016,129253,93014,34483,256750,94.81166913
3/3/2016,129430,92892,34350,256672,94.78286558
3/4/2016,129412,92634,34214,256260,94.63072378
3/5/2016,129306,92299,34052,255657,94.40805022
3/6/2016,129148,91888,33925,254961,94.15103397
3/7/2016,129042,91431,33775,254248,93.88774003
3/8/2016,128972,91036,33625,253633,93.66063516
3/9/2016,128813,90731,33490,253034,93.4394387
3/10/2016,128690,90610,33341,252641,93.29431315
3/11/2016,128725,90731,33235,252691,93.31277696
3/12/2016,128813,91005,33129,252947,93.40731167
3/13/2016,128849,91142,33005,252996,93.4254062
3/14/2016,128919,91279,32862,253060,93.44903988
3/15/2016,128937,91370,32805,253112,93.46824225
3/16/2016,128849,91462,32647,252958,93.41137371
3/17/2016,128884,91416,32486,252786,93.3478582
3/18/2016,128866,91188,32349,252403,93.20642541
3/19/2016,128813,90990,32377,252180,93.12407681
3/20/2016,128901,90868,32386,252155,93.1148449
3/21/2016,128866,90564,32396,251826,92.99335303
3/22/2016,128849,90245,32405,251499,92.8725997
3/23/2016,128673,89895,32410,250978,92.68020679
3/24/2016,128497,89560,32396,250453,92.48633678
3/25/2016,128514,89195,32396,250105,92.35782866
3/26/2016,128549,88845,32396,249790,92.24150665
3/27/2016,128532,88450,32386,249368,92.08567208
3/28/2016,128567,88042,32386,248995,91.94793205
3/29/2016,128585,87826,32481,248892,91.9098966
3/30/2016,128549,87666,32515,248730,91.85007386
3/31/2016,128532,87536,32567,248635,91.81499261
4/1/2016,128532,87435,32615,248582,91.79542097
4/2/2016,128585,87392,32667,248644,91.8183161
4/3/2016,128690,87421,32747,248858,91.89734121
4/4/2016,128884,87739,32786,249409,92.10081241
4/5/2016,129007,87782,32843,249632,92.183161
4/6/2016,128866,87724,32838,249428,92.10782866
4/7/2016,128901,87695,32876,249472,92.12407681
4/8/2016,130138,89438,33201,252777,93.34453471
4/9/2016,131167,91325,33307,255799,94.46048744
4/10/2016,132076,92542,33446,258064,95.29689808
4/11/2016,132826,93425,33563,259814,95.94313146
4/12/2016,133599,93987,33746,261332,96.50369276
4/13/2016,134372,94428,33959,262759,97.03064993
4/14/2016,135004,94626,34121,263751,97.39697194
4/15/2016,135493,94733,33843,264069,97.51440177
4/16/2016,135946,94733,33543,264222,97.57090103
4/17/2016,136381,94672,33620,264673,97.73744461
4/18/2016,136799,94504,33717,265020,97.86558346
4/19/2016,137218,94291,33804,265313,97.97378139
4/20/2016,137310,94368,33872,265550,98.06129985
4/21/2016,137181,94535,33925,265641,98.09490399
4/22/2016,137346,94459,33993,265798,98.15288035
4/23/2016,137638,94291,34028,265957,98.21159527
4/24/2016,137893,94094,34067,266054,98.24741507
4/25/2016,138113,93820,34111,266044,98.2437223
4/26/2016,138296,93577,34160,266033,98.23966027
4/27/2016,138480,93470,34228,266178,98.29320532
4/28/2016,138811,93303,34291,266405,98.37703102
4/29/2016,138664,93059,34340,266063,98.25073855
4/30/2016,138425,92816,34443,265684,98.11078287
5/1/2016,138572,92542,34518,265632,98.0915805
5/2/2016,138885,92436,34596,265917,98.19682422
5/3/2016,139142,92770,34665,266577,98.44054653
5/4/2016,139289,93166,34587,267042,98.61225997
5/5/2016,139308,93546,34572,267426,98.75406204
5/6/2016,139345,93911,34533,267789,98.88810931
5/7/2016,139693,94398,34725,268816,99.26735598
5/8/2016,139969,94854,34922,269745,99.61041359
5/9/2016,140043,95219,35011,270273,99.80539143
5/10/2016,140079,95554,35026,270659,99.94793205
5/11/2016,140061,95867,35041,270969,100.0624077
5/12/2016,140024,96108,35055,271187,100.1429099
5/13/2016,139895,96269,35065,271229,100.1584195
5/14/2016,140061,96623,35070,271754,100.3522895
5/15/2016,140024,96816,35050,271890,100.4025111
5/16/2016,139914,96848,34892,271654,100.3153619
5/17/2016,139785,96848,34730,271363,100.2079025
5/18/2016,139601,96832,34587,271020,100.0812408
5/19/2016,139472,96591,34448,270511,99.89327917
5/20/2016,139326,96334,34428,270088,99.73707533
5/21/2016,139234,96108,34433,269775,99.62149188
5/22/2016,139087,95915,34478,269480,99.51255539
5/23/2016,138976,95738,34523,269237,99.42282127
5/24/2016,139013,95554,34562,269129,99.38293944
5/25/2016,139197,95326,34591,269114,99.3774003
5/26/2016,139142,95113,34487,268742,99.24002954
5/27/2016,139068,94854,34370,268292,99.07385524
5/28/2016,138976,94520,34296,267792,98.88921713
5/29/2016,138811,94200,34291,267302,98.70827179
5/30/2016,138572,93820,34296,266688,98.48153619
5/31/2016,138425,93440,34296,266161,98.28692762
6/1/2016,137930,93014,34072,265016,97.86410635
6/2/2016,137693,92558,34037,264288,97.59527326
6/3/2016,137437,92070,34003,263510,97.30797637
6/4/2016,137310,91827,33993,263130,97.1676514
6/5/2016,137419,91690,33983,263092,97.15361891
6/6/2016,137875,92055,34160,264090,97.52215657
6/7/2016,137730,92192,34204,264126,97.53545052
6/8/2016,137730,92223,34204,264157,97.54689808
6/9/2016,137492,92162,34194,263848,97.43279173
6/10/2016,137127,92040,34126,263293,97.22784343
6/11/2016,136799,91659,34086,262544,96.95125554
6/12/2016,136508,91203,34067,261778,96.66838996
6/13/2016,136109,90762,34032,260903,96.34527326
6/14/2016,135765,90321,33998,260084,96.04283604
6/15/2016,135294,89849,33969,259112,95.68389956
6/16/2016,134877,89378,33929,258184,95.34121123
6/17/2016,134588,88861,33896,257345,95.03138848
6/18/2016,134318,88343,33848,256509,94.72267356
6/19/2016,134012,87898,33809,255719,94.43094535
6/20/2016,133707,87435,33761,254903,94.12961595
6/21/2016,133401,86987,33539,253927,93.76920236
6/22/2016,133114,86525,33379,253018,93.43353028
6/23/2016,132773,86063,33211,252047,93.07496307
6/24/2016,132469,85557,33168,251194,92.75997046
6/25/2016,132022,85268,33105,250395,92.46491876
6/26/2016,131523,84979,33048,249550,92.15288035
6/27/2016,131043,84689,32995,248727,91.84896603
6/28/2016,130759,84241,32857,247857,91.52769572
6/29/2016,130351,84328,32738,247417,91.36521418
6/30/2016,129890,84212,32567,246669,91.08899557
7/1/2016,129412,84126,32401,245939,90.81942393
7/2/2016,128954,83851,32264,245069,90.49815362
7/3/2016,128514,83648,32194,244356,90.23485968
7/4/2016,128022,83403,32140,243565,89.94276219
7/5/2016,127565,83172,32090,242827,89.67023634
7/6/2016,127093,82593,31929,241615,89.22267356
7/7/2016,126621,82333,31713,240667,88.8725997
7/8/2016,126307,82131,31475,239913,88.59416544
7/9/2016,126236,81885,31313,239434,88.41728213
7/10/2016,126603,81871,31484,239958,88.61078287
7/11/2016,126673,81712,31541,239926,88.59896603
7/12/2016,126638,81510,31438,239586,88.47341211
7/13/2016,126167,81250,31271,238688,88.14180207
7/14/2016,125747,81018,31026,237791,87.8105613
7/15/2016,125366,80792,30795,236953,87.50110783
7/16/2016,124932,80530,30373,235835,87.08825702
7/17/2016,124551,80308,30128,234987,86.77511078
7/18/2016,124135,79825,30100,234060,86.43279173
7/19/2016,123773,79548,29910,233231,86.12666174
7/20/2016,123756,78857,29860,232473,85.84675037
7/21/2016,123722,78125,29819,231666,85.54874446
7/22/2016,123687,77379,29760,230826,85.23855244
7/23/2016,123635,76633,29724,229992,84.93057607
7/24/2016,123583,75777,29665,229025,84.57348597
7/25/2016,123514,74851,29611,227976,84.18611521
7/26/2016,123549,74243,29589,227381,83.96639586
7/27/2016,123170,73874,29414,226458,83.62555391
7/28/2016,122670,73622,29195,225487,83.26698671
7/29/2016,122327,73424,28977,224728,82.98670606
7/30/2016,121899,73159,28756,223814,82.64918759
7/31/2016,121660,73079,28738,223477,82.52474151
8/1/2016,121351,72960,28716,223027,82.35856721
8/2/2016,121231,72894,28734,222859,82.2965288
8/3/2016,121060,72907,28712,222679,82.23005908
8/4/2016,120735,72801,28646,222182,82.0465288
8/5/2016,120327,72642,28592,221561,81.81720827
8/6/2016,119902,72430,28425,220757,81.52031019
8/7/2016,119580,72245,28368,220193,81.3120384
8/8/2016,119155,72020,28311,219486,81.05096012
8/9/2016,118681,71781,28250,218712,80.76514032
8/10/2016,118192,71543,28184,217919,80.47230428
8/11/2016,117989,71265,28154,217408,80.28360414
8/12/2016,117669,70828,27983,216480,79.94091581
8/13/2016,117736,71132,27835,216703,80.0232644
8/14/2016,118039,71291,27896,217226,80.21639586
8/15/2016,117888,71371,27970,217229,80.21750369
8/16/2016,117635,71278,27875,216788,80.05465288
8/17/2016,117366,71159,27757,216282,79.86779911
8/18/2016,117048,71040,27740,215828,79.70014771
8/19/2016,116713,70589,27653,214955,79.37776957
8/20/2016,116294,70099,27528,213921,78.99593796
8/21/2016,115893,69847,27494,213234,78.7422452
8/22/2016,115625,69834,27472,212931,78.63035451
8/23/2016,115243,69450,27434,212127,78.33345643
8/24/2016,114812,68974,27391,211177,77.98264402
8/25/2016,114313,68550,27331,210194,77.61964549
8/26/2016,113865,68099,27288,209252,77.2717873
8/27/2016,113453,67689,27227,208369,76.9457164
8/28/2016,112975,67450,27180,207605,76.66358936
8/29/2016,112563,67216,27124,206903,76.40435746
8/30/2016,112481,66681,27073,206235,76.15768095
8/31/2016,112398,66095,27009,205502,75.88700148
9/1/2016,112365,65535,26949,204849,75.64586411
9/2/2016,112316,64835,26906,204057,75.35339734
9/3/2016,111889,64082,26864,202835,74.9021418
9/4/2016,111415,63408,26804,201627,74.45605613
9/5/2016,110941,62683,26766,200390,73.99926145
9/6/2016,110436,61817,26710,198963,73.47230428
9/7/2016,109932,61053,26668,197653,72.98855244
9/8/2016,109883,60317,26617,196817,72.67983752
9/9/2016,109819,59816,26511,196146,72.43205318
9/10/2016,109689,59145,26397,195231,72.09416544
9/11/2016,109624,58510,26359,194493,71.82163959
9/12/2016,109559,57728,26312,193599,71.49150665
9/13/2016,109154,56825,26261,192240,70.98966027
9/14/2016,108669,55872,26215,190756,70.44165436
9/15/2016,108250,54813,26156,189219,69.87407681
9/16/2016,107734,53646,26106,187486,69.23412112
9/17/2016,107220,52525,26022,185767,68.5993353
9/18/2016,106788,51931,25959,184678,68.1971935
9/19/2016,106452,51954,25929,184335,68.07053176
9/20/2016,106084,52257,25908,184249,68.038774
9/21/2016,105637,51558,25862,183057,67.59859675
9/22/2016,105129,50717,25813,181659,67.0823486
9/23/2016,104653,49889,25750,180292,66.57754801
9/24/2016,104177,49247,25703,179127,66.14734121
9/25/2016,103688,48670,25642,178000,65.73116691
9/26/2016,103183,48103,25591,176877,65.31646972
9/27/2016,102822,47558,25533,175913,64.96048744
9/28/2016,102367,46969,25487,174823,64.55797637
9/29/2016,101914,46435,25433,173782,64.17355982
9/30/2016,101523,46024,25387,172934,63.86041359
10/1/2016,101117,45534,25329,171980,63.50812408
10/2/2016,100761,45012,25304,171077,63.17466765
10/3/2016,100450,44344,25275,170069,62.80243722
10/4/2016,100109,43699,25246,169054,62.42762186
10/5/2016,99769,43309,25197,168275,62.13995569
10/6/2016,99428,42952,25172,167552,61.87296898
10/7/2016,99106,42531,25122,166759,61.58013294
10/8/2016,98690,42111,25089,165890,61.25923191
10/9/2016,98229,41722,25056,165007,60.933161
10/10/2016,97755,41343,25014,164112,60.60265879
10/11/2016,97298,40955,24977,163230,60.27695716
10/12/2016,96780,40514,24936,162230,59.90768095
10/13/2016,96234,40031,24895,161160,59.51255539
10/14/2016,95750,39558,24863,160171,59.14734121
10/15/2016,95176,38570,24764,158510,58.53397341
10/16/2016,94635,37609,24711,156955,57.95974889
10/17/2016,94126,36657,24682,155465,57.40952733
10/18/2016,93527,35716,24645,153888,56.82717873
10/19/2016,92873,34904,24515,152292,56.23781388
10/20/2016,92264,34131,24389,150784,55.68094535
10/21/2016,91806,33774,24173,149753,55.30022157
10/22/2016,91423,33102,23983,148508,54.84047267
10/23/2016,90863,32546,23938,147347,54.41174298
10/24/2016,90219,31962,23914,146095,53.94940916
10/25/2016,89462,31202,23882,144546,53.3774003
10/26/2016,88662,30516,23705,142883,52.76329394
10/27/2016,88157,30182,23501,141840,52.37813885
10/28/2016,87681,29709,23382,140772,51.98375185
10/29/2016,87023,29542,23207,139772,51.61447563
10/30/2016,86294,29144,23012,138450,51.12629247
10/31/2016,85611,28764,22826,137201,50.66506647
11/1/2016,85087,28396,22811,136294,50.33013294
11/2/2016,84594,28132,22791,135517,50.04320532
11/3/2016,84103,27877,22768,134748,49.75923191
11/4/2016,83667,27375,22752,133794,49.40694239
11/5/2016,83165,26864,22713,132742,49.01846381
11/6/2016,82538,26285,22694,131517,48.56610044
11/7/2016,81940,25690,22669,130299,48.11632201
11/8/2016,81168,25009,22525,128702,47.52658789
11/9/2016,80533,24248,22501,127282,47.00221566
11/10/2016,79960,23505,22470,125935,46.50480059
11/11/2016,79155,22755,22443,124353,45.92060561
11/12/2016,78342,21989,22412,122743,45.3260709
11/13/2016,77521,21200,22388,121109,44.72267356
11/14/2016,76702,20449,22369,119520,44.13589365
11/15/2016,75944,19900,22186,118030,43.58567208
11/16/2016,75347,19408,21988,116743,43.11041359
11/17/2016,74701,18951,21737,115389,42.61041359
11/18/2016,74124,18550,21500,114174,42.16174298
11/19/2016,73576,18311,21237,113124,41.77400295
11/20/2016,73081,18093,20991,112165,41.41986706
11/21/2016,72574,17840,20742,111156,41.04726736
11/22/2016,72072,17537,20484,110093,40.65472674
11/23/2016,71545,17376,20220,109141,40.30317578
11/24/2016,71172,17249,20053,108474,40.05686854
11/25/2016,70765,17144,19862,107771,39.79726736
11/26/2016,70371,17024,19675,107070,39.53840473
11/27/2016,70053,16996,19485,106534,39.34047267
11/28/2016,69776,17319,19311,106406,39.29320532
11/29/2016,69625,17755,19307,106687,39.39697194
11/30/2016,69763,18430,19708,107901,39.84527326
12/1/2016,70613,19493,20009,110115,40.66285081
12/2/2016,71725,20821,20238,112784,41.64844904
12/3/2016,72419,21958,20205,114582,42.31240768
12/4/2016,72886,22855,20090,115831,42.77363368
12/5/2016,73250,23621,19957,116828,43.14180207
12/6/2016,73497,24241,19792,117530,43.40103397
12/7/2016,73745,24881,19635,118261,43.67097489
12/8/2016,73953,25494,19464,118911,43.91100443
12/9/2016,73967,26038,19275,119280,44.04726736
12/10/2016,74006,26302,19079,119387,44.08677991
12/11/2016,74084,26430,18875,119389,44.08751846
12/12/2016,74202,26541,18689,119432,44.10339734
12/13/2016,74281,26549,18715,119545,44.14512555
12/14/2016,74426,26524,18771,119721,44.21011817
12/15/2016,74439,26455,18786,119680,44.19497784
12/16/2016,74413,26302,18811,119526,44.13810931
12/17/2016,74439,26132,18843,119414,44.09675037
12/18/2016,74596,26064,18917,119577,44.15694239
12/19/2016,76702,27579,19544,123825,45.72562777
12/20/2016,77816,28430,19752,125998,46.52806499
12/21/2016,78600,29023,19909,127532,47.09453471
12/22/2016,79100,29821,20042,128963,47.62296898
12/23/2016,79442,30590,20157,130189,48.07570162
12/24/2016,79673,31053,20253,130979,48.36742984
12/25/2016,79891,31434,20376,131701,48.63404727
12/26/2016,80069,31795,20488,132352,48.87444609
12/27/2016,80178,32203,20581,132962,49.09970458
12/28/2016,80574,32582,20720,133876,49.43722304
12/29/2016,80878,32926,20799,134603,49.70568685
12/30/2016,81154,33130,20923,135207,49.92872969
12/31/2016,81374,33269,21014,135657,50.09490399
1/1/2017,81540,33626,21089,136255,50.31573117
1/2/2017,81678,33765,21169,136612,50.44756278
1/3/2017,81815,33883,21253,136951,50.57274742
1/4/2017,82232,34320,21443,137995,50.95827179
1/5/2017,82788,35152,21641,139581,51.54394387
1/6/2017,83165,35706,21784,140655,51.94054653
1/7/2017,83443,36112,21876,141431,52.22710487
1/8/2017,83625,36380,21953,141958,52.42171344
1/9/2017,83780,36528,22028,142336,52.56129985
1/10/2017,83948,36954,22093,142995,52.80465288
1/11/2017,84257,37410,22182,143849,53.12001477
1/12/2017,84524,37757,22236,144517,53.36669129
1/13/2017,86423,39369,22752,148544,54.85376662
1/14/2017,87825,40871,23155,151851,56.07496307
1/15/2017,88792,41922,23389,154103,56.90657312
1/16/2017,89491,42720,23569,155780,57.52584934
1/17/2017,90074,43309,23641,157024,57.98522895
1/18/2017,90878,44066,23813,158757,58.62518464
1/19/2017,91688,44889,23987,160564,59.29246677
1/20/2017,92501,45556,24173,162230,59.90768095
1/21/2017,93155,46346,24319,163820,60.49483013
1/22/2017,93737,47102,24523,165362,61.06425406
1/23/2017,94261,47880,24842,166983,61.66285081
1/24/2017,94920,48626,25246,168792,62.33087149
1/25/2017,95508,49375,25562,170445,62.94128508
1/26/2017,96114,50029,25750,171893,63.47599705
1/27/2017,96765,50717,25971,173453,64.05206795
1/28/2017,97343,51546,26152,175041,64.63847858
1/29/2017,97816,52246,26303,176365,65.1274003
1/30/2017,98260,52864,26440,177564,65.57016248
1/31/2017,98552,53401,26473,178426,65.88847858
2/1/2017,98860,53879,26591,179330,66.22230428
2/2/2017,99213,54358,26693,180264,66.56720827
2/3/2017,99551,54766,26727,181044,66.85524372
2/4/2017,99831,55115,26799,181745,67.11410635
2/5/2017,100048,55420,26877,182345,67.33567208
2/6/2017,100249,55750,26945,182944,67.55686854
2/7/2017,100342,56080,26992,183414,67.73042836
2/8/2017,100683,56532,26996,184211,68.02474151
2/9/2017,101382,57521,27154,186057,68.70642541
2/10/2017,101758,58217,27236,187211,69.13257016
2/11/2017,102101,58790,27257,188148,69.47858198
2/12/2017,102523,59413,27344,189280,69.89660266
2/13/2017,103058,60060,27464,190582,70.3774003
2/14/2017,103294,60610,27451,191355,70.66285081
2/15/2017,103515,61091,27447,192053,70.92060561
2/16/2017,103815,61587,27498,192900,71.23338257
2/17/2017,104019,61995,27481,193495,71.45310192
2/18/2017,104304,62390,27438,194132,71.68833087
2/19/2017,104638,62797,27507,194942,71.98744461
2/20/2017,105193,63433,27632,196258,72.47341211
2/21/2017,105701,64173,27727,197601,72.96935007
2/22/2017,106180,64784,27805,198769,73.4006647
2/23/2017,106580,65497,27892,199969,73.84379616
2/24/2017,107476,66516,27957,201949,74.57496307
2/25/2017,109251,68351,28486,206088,76.10339734
2/26/2017,112250,73040,29652,214942,79.37296898
2/27/2017,114379,76315,30213,220907,81.57570162
2/28/2017,115876,78387,30533,224796,83.01181684
3/1/2017,116746,80004,30401,227151,83.88146233
3/2/2017,117501,81322,30296,229119,84.60819793
3/3/2017,118090,82478,30510,231078,85.33161004
3/4/2017,118445,83374,30510,232329,85.79357459
3/5/2017,118579,84039,30350,232968,86.0295421
3/6/2017,118714,84632,30186,233532,86.23781388
3/7/2017,118934,84935,30204,234073,86.43759232
3/8/2017,119175,85152,30383,234710,86.67282127
3/9/2017,119444,85441,30533,235418,86.93426883
3/10/2017,119665,85513,30657,235835,87.08825702
3/11/2017,120038,85542,30552,236132,87.19793205
3/12/2017,120344,85441,30405,236190,87.21935007
3/13/2017,120667,85282,30232,236181,87.21602659
3/14/2017,120872,85210,30218,236300,87.25997046
3/15/2017,121060,85065,30314,236439,87.31129985
3/16/2017,121180,85152,30387,236719,87.41469719
3/17/2017,121248,85383,30451,237082,87.54874446
3/18/2017,121334,85759,30273,237366,87.65361891
3/19/2017,121351,85875,30319,237545,87.71971935
3/20/2017,121368,86005,30392,237765,87.80096012
3/21/2017,121626,85831,30451,237908,87.85376662
3/22/2017,121899,85326,30492,237717,87.78323486
3/23/2017,121951,84400,30529,236880,87.47415066
3/24/2017,122053,83316,30570,235939,87.12666174
3/25/2017,122121,82305,30634,235060,86.80206795
3/26/2017,122207,81452,30712,234371,86.54763663
3/27/2017,122722,81076,30822,234620,86.63958641
3/28/2017,124118,81640,31099,236857,87.46565731
3/29/2017,126149,83215,31527,240891,88.95531758
3/30/2017,128339,85499,32027,245865,90.79209749
3/31/2017,129890,87305,32241,249436,92.11078287
4/1/2017,131594,89758,32439,253791,93.7189808
4/2/2017,132791,91979,32747,257517,95.09490399
4/3/2017,133707,93333,33024,260064,96.03545052
4/4/2017,134768,94550,33427,262745,97.02548006
4/5/2017,136763,96543,34433,267739,98.86964549
4/6/2017,138351,97637,34966,270954,100.0568685
4/7/2017,141116,99585,35438,276139,101.9715657
4/8/2017,142285,100743,35259,278287,102.764771
4/9/2017,142230,100550,35180,277960,102.6440177
4/10/2017,141968,99874,35135,276977,102.2810192
4/11/2017,141524,99118,35120,275762,101.8323486
4/12/2017,141172,98201,35095,274468,101.3545052
4/13/2017,140727,97637,35080,273444,100.9763663
4/14/2017,140560,97138,34976,272674,100.6920236
4/15/2017,140246,96671,34853,271770,100.3581979
4/16/2017,139978,96301,34730,271009,100.0771787
4/17/2017,139877,96189,34601,270667,99.95088626
4/18/2017,139693,96205,34567,270465,99.87629247
4/19/2017,139308,95931,34443,269682,99.58714919
4/20/2017,139050,95770,34340,269160,99.394387
4/21/2017,139271,96269,34340,269880,99.66026588
4/22/2017,139822,97186,34640,271648,100.3131462
4/23/2017,140171,97347,34788,272306,100.55613
4/24/2017,140357,97202,34759,272318,100.5605613
4/25/2017,140412,96929,34873,272214,100.5221566
4/26/2017,140227,96671,34991,271889,100.4021418
4/27/2017,139987,96414,34922,271323,100.1931315
4/28/2017,139804,96108,34828,270740,99.97784343
4/29/2017,139656,95787,34725,270168,99.76661743
4/30/2017,139546,95523,34626,269695,99.59194978
5/1/2017,139785,95706,34518,270009,99.70790251
5/2/2017,141913,96848,34660,273421,100.967873
5/3/2017,142322,98056,34843,275221,101.6325702
5/4/2017,141931,98233,34931,275095,101.5860414
5/5/2017,141598,98184,35016,274798,101.4763663
5/6/2017,141672,98458,34951,275081,101.5808715
5/7/2017,141468,98555,34946,274969,101.5395126
5/8/2017,141246,98523,34936,274705,101.4420236
5/9/2017,141023,98378,34853,274254,101.2754801
5/10/2017,140783,98152,34848,273783,101.101551
5/11/2017,140653,97927,34936,273516,101.0029542
5/12/2017,140542,97685,34996,273223,100.8947563
5/13/2017,140560,97508,35026,273094,100.8471196
5/14/2017,140931,97589,35100,273620,101.0413589
5/15/2017,140894,97669,35075,273638,101.0480059
5/16/2017,140820,97669,34971,273460,100.9822747
5/17/2017,140671,97557,34897,273125,100.8585672
5/18/2017,140486,97396,34788,272670,100.6905465
5/19/2017,140431,97283,34769,272483,100.6214919
5/20/2017,140449,97154,34823,272426,100.6004431
5/21/2017,140375,96977,34902,272254,100.5369276
5/22/2017,140264,96752,34837,271853,100.3888479
5/23/2017,140190,96671,34868,271729,100.3430576
5/24/2017,140043,96559,34873,271475,100.2492614
5/25/2017,140006,96285,34887,271178,100.1395864
5/26/2017,140098,96092,34863,271053,100.0934269
5/27/2017,140209,95963,34803,270975,100.0646233
5/28/2017,140171,95899,34848,270918,100.0435746
5/29/2017,139987,95803,34833,270623,99.93463811
5/30/2017,140209,95787,34961,270957,100.0579764
5/31/2017,140486,96076,34927,271489,100.2544313
6/1/2017,140431,96494,34907,271832,100.3810931
6/2/2017,140301,96543,34956,271800,100.3692762
6/3/2017,140153,96591,34966,271710,100.3360414
6/4/2017,139951,96575,34912,271438,100.2355982
6/5/2017,139969,96607,34981,271557,100.2795421
6/6/2017,141172,98184,35394,274750,101.4586411
6/7/2017,141524,99215,35234,275973,101.9102659
6/8/2017,141283,99086,35065,275434,101.711226
6/9/2017,140987,98555,34981,274523,101.3748154
6/10/2017,140746,97959,34917,273622,101.0420975
6/11/2017,140449,97251,34981,272681,100.6946086
6/12/2017,140264,96398,35031,271693,100.3297637
6/13/2017,140153,95706,35011,270870,100.0258493
6/14/2017,140024,95295,34956,270275,99.80612999
6/15/2017,139969,95265,34858,270092,99.73855244
6/16/2017,139877,95113,34907,269897,99.66654357
6/17/2017,139877,95113,34843,269833,99.6429099
6/18/2017,139840,94915,34873,269628,99.56720827
6/19/2017,139914,94839,34927,269680,99.58641064
6/20/2017,140394,95189,35065,270648,99.94387001
6/21/2017,140135,95478,34912,270525,99.89844904
6/22/2017,139859,95539,34725,270123,99.75
6/23/2017,139564,95539,34538,269641,99.57200886
6/24/2017,139455,95569,34306,269330,99.45716396
6/25/2017,139289,95584,34140,269013,99.3401034
6/26/2017,139032,95356,34081,268469,99.13921713
6/27/2017,138756,95006,34067,267829,98.90288035
6/28/2017,138314,94641,34037,266992,98.59379616
6/29/2017,137912,94215,34023,266150,98.28286558
6/30/2017,137547,93653,33998,265198,97.93131462
7/1/2017,137492,93348,33843,264683,97.74113737
7/2/2017,137492,93059,33906,264457,97.65768095
7/3/2017,137419,92694,33910,264023,97.49741507
7/4/2017,137176,92283,33896,263355,97.25073855
7/5/2017,136981,91736,33867,262584,96.96602659
7/6/2017,136708,91203,33848,261759,96.66137371
7/7/2017,136417,90655,33824,260896,96.34268833
7/8/2017,136127,90108,33799,260034,96.02437223
7/9/2017,135964,89591,33775,259330,95.76440177
7/10/2017,135674,88967,33736,258377,95.41248154
7/11/2017,135312,88465,33630,257407,95.0542836
7/12/2017,134949,88071,33534,256554,94.73929099
7/13/2017,134678,87840,33473,255991,94.53138848
7/14/2017,134787,88115,33422,256324,94.65435746
7/15/2017,134986,88313,33480,256779,94.82237814
7/16/2017,134841,88252,33485,256578,94.74815362
7/17/2017,134606,88071,33465,256142,94.58714919
7/18/2017,134354,88100,33441,255895,94.49593796
7/19/2017,133977,87941,33336,255254,94.25923191
7/20/2017,133617,87666,33173,254456,93.96454948
7/21/2017,133293,87363,32991,253647,93.66580502
7/22/2017,132952,87002,32843,252797,93.35192024
7/23/2017,132611,86684,32800,252095,93.09268833
7/24/2017,132952,86785,32800,252537,93.25590842
7/25/2017,133491,87334,32853,253678,93.67725258
7/26/2017,133617,87623,32876,254116,93.83899557
7/27/2017,133527,87666,32876,254069,93.82163959
7/28/2017,133365,87623,32843,253831,93.73375185
7/29/2017,133114,87479,32795,253388,93.57016248
7/30/2017,132791,87262,32733,252786,93.3478582
7/31/2017,132434,86973,32657,252064,93.08124077
8/1/2017,132058,86669,32600,251327,92.80908419
8/2/2017,131630,86323,32491,250444,92.48301329
8/3/2017,131702,86048,32486,250236,92.40620384
8/4/2017,131487,85759,32405,249651,92.19017725
8/5/2017,131202,85456,32453,249111,91.99076809
8/6/2017,130901,85109,32491,248501,91.7655096
8/7/2017,130546,84718,32468,247732,91.48153619
8/8/2017,130191,84371,32410,246972,91.20088626
8/9/2017,129784,83981,32405,246170,90.90472674
8/10/2017,129430,83576,32373,245379,90.61262925
8/11/2017,129007,83143,32264,244414,90.2562777
8/12/2017,128743,82810,32382,243935,90.07939439
8/13/2017,128462,82478,32557,243497,89.9176514
8/14/2017,128093,82175,32605,242873,89.68722304
8/15/2017,127741,81813,32529,242083,89.39549483
8/16/2017,127407,81423,32449,241279,89.09859675
8/17/2017,127006,81163,32311,240480,88.80354505
8/18/2017,126586,80961,32216,239763,88.538774
8/19/2017,126447,81134,32435,240016,88.63220089
8/20/2017,126184,81221,32216,239621,88.48633678
8/21/2017,125888,81177,32236,239301,88.36816839
8/22/2017,125504,80847,32047,238398,88.03471196
8/23/2017,125313,80737,31850,237900,87.85081241
8/24/2017,125175,80599,31658,237432,87.67799114
8/25/2017,124846,80308,31545,236699,87.40731167
8/26/2017,124515,79991,31512,236018,87.15583456
8/27/2017,124153,79617,31466,235236,86.86706056
8/28/2017,123756,79244,31425,234425,86.56757755
8/29/2017,123359,78830,31308,233497,86.22488922
8/30/2017,122929,78401,31248,232578,85.88552437
8/31/2017,122481,77987,31211,231679,85.55354505
9/1/2017,122104,77559,31090,230753,85.21159527
9/2/2017,121677,77075,31039,229791,84.85635155
9/3/2017,121334,76675,31017,229026,84.57385524
9/4/2017,121112,76274,31035,228421,84.35044313
9/5/2017,120770,75873,31012,227655,84.06757755
9/6/2017,120378,75486,30957,226821,83.75960118
9/7/2017,120633,75196,31072,226901,83.78914328
9/8/2017,120787,74892,31132,226811,83.75590842
9/9/2017,120667,74561,31159,226387,83.5993353
9/10/2017,120395,74188,31155,225738,83.35967504
9/11/2017,120123,73795,31141,225059,83.10893648
9/12/2017,119834,73410,31081,224325,82.83788774
9/13/2017,119495,73000,31039,223534,82.54579025
9/14/2017,119240,72629,31012,222881,82.30465288
9/15/2017,119002,72245,30928,222175,82.04394387
9/16/2017,118630,71848,30841,221319,81.72784343
9/17/2017,118276,71384,30836,220496,81.4239291
9/18/2017,117905,71000,30818,219723,81.13847858
9/19/2017,117585,70775,30693,219053,80.89106352
9/20/2017,117216,70364,30670,218250,80.59453471
9/21/2017,116830,70046,30538,217414,80.28581979
9/22/2017,116478,69477,30429,216384,79.90546529
9/23/2017,116026,68775,30305,215106,79.43353028
9/24/2017,115608,68033,30278,213919,78.99519941
9/25/2017,115160,67254,30250,212664,78.53175775
9/26/2017,114728,66452,30073,211253,78.01070901
9/27/2017,114263,65663,29941,209867,77.49889217
9/28/2017,113782,64784,29892,208458,76.97858198
9/29/2017,113354,63942,29783,207079,76.46935007
9/30/2017,113024,63064,29747,205835,76.00997046
10/1/2017,112613,62033,29715,204361,75.46565731
10/2/2017,112135,60964,29692,202791,74.88589365
10/3/2017,111710,59914,29652,201276,74.32644018
10/4/2017,111235,58876,29620,199731,73.75590842
10/5/2017,110827,57936,29593,198356,73.24815362
10/6/2017,110404,56983,29477,196864,72.6971935
10/7/2017,109965,56043,29468,195476,72.18463811
10/8/2017,109559,55176,29464,194199,71.71307238
10/9/2017,109251,54848,29509,193608,71.49483013
10/10/2017,109283,54591,29647,193521,71.4627031
10/11/2017,109251,54171,29710,193132,71.31905465
10/12/2017,109218,53797,29710,192725,71.16875923
10/13/2017,109202,53482,29710,192394,71.0465288
10/14/2017,109202,52980,29531,191713,70.7950517
10/15/2017,109202,52210,29347,190759,70.44276219
10/16/2017,109234,51394,29159,189787,70.0838257
10/17/2017,109234,50542,28879,188655,69.66580502
10/18/2017,109218,49667,28592,187477,69.23079764
10/19/2017,109170,48770,28289,186229,68.76994092
10/20/2017,109154,47892,28001,185047,68.33345643
10/21/2017,109137,46991,27727,183855,67.89327917
10/22/2017,109121,46135,27417,182673,67.45679468
10/23/2017,109105,45367,27107,181579,67.0528065
10/24/2017,108765,44900,26821,180486,66.64918759
10/25/2017,108653,44500,27068,180221,66.55132939
10/26/2017,108395,43811,27146,179352,66.23042836
10/27/2017,108056,43130,27193,178379,65.8711226
10/28/2017,107750,42689,27236,177675,65.61115214
10/29/2017,107428,42331,27262,177021,65.36964549
10/30/2017,109640,42573,29039,181252,66.93205318
10/31/2017,111873,44934,29950,186757,68.96491876
11/1/2017,112662,45968,30227,188857,69.74039882
11/2/2017,113057,46668,30209,189934,70.13810931
11/3/2017,113322,47180,30150,190652,70.40324963
11/4/2017,113535,47636,30191,191362,70.66543575
11/5/2017,113601,48025,30296,191922,70.87223043
11/6/2017,113568,48325,30410,192303,71.01292467
11/7/2017,113683,48726,30538,192947,71.25073855
11/8/2017,113486,49107,30630,193223,71.35265879
11/9/2017,113420,49422,30726,193568,71.48005908
11/10/2017,113239,49679,30822,193740,71.54357459
11/11/2017,113090,49924,30698,193712,71.53323486
11/12/2017,112909,50169,30781,193859,71.58751846
11/13/2017,112695,50367,30845,193907,71.60524372
11/14/2017,112481,50554,30675,193710,71.53249631
11/15/2017,112250,50449,30721,193420,71.4254062
11/16/2017,112070,50297,30795,193162,71.33013294
11/17/2017,111808,50157,30744,192709,71.16285081
11/18/2017,111710,50017,30813,192540,71.10044313
11/19/2017,111710,49924,30975,192609,71.12592319
11/20/2017,111792,49982,31206,192980,71.26292467
11/21/2017,112053,50297,31304,193654,71.51181684
11/22/2017,112119,50367,31391,193877,71.59416544
11/23/2017,112021,50309,31382,193712,71.53323486
11/24/2017,112021,50251,31461,193733,71.54098966
11/25/2017,111971,50146,31551,193668,71.51698671
11/26/2017,111906,50052,31611,193569,71.48042836
11/27/2017,111808,49971,31663,193442,71.43353028
11/28/2017,111988,50006,31485,193479,71.4471935
11/29/2017,112119,49866,31289,193274,71.37149188
11/30/2017,112316,50029,31118,193463,71.44128508
12/1/2017,112185,49866,31179,193230,71.35524372
12/2/2017,112037,49725,31225,192987,71.2655096
12/3/2017,111939,49562,31266,192767,71.18426883
12/4/2017,111857,49375,31313,192545,71.10228951
12/5/2017,111776,49189,31193,192158,70.95937962
12/6/2017,111792,49037,31285,192114,70.94313146
12/7/2017,112021,48959,31206,192186,70.96971935
12/8/2017,112168,48826,31090,192084,70.93205318
12/9/2017,112234,48781,31017,192032,70.91285081
12/10/2017,112135,48703,31099,191937,70.87776957
12/11/2017,112053,48614,31155,191822,70.83530281
12/12/2017,111922,48526,31159,191607,70.75590842
12/13/2017,111726,48414,31211,191351,70.66137371
12/14/2017,111513,48359,31085,190957,70.51587888
12/15/2017,111203,48114,30900,190217,70.24261448
12/16/2017,110908,47814,30726,189448,69.95864106
12/17/2017,110680,47591,30762,189033,69.80539143
12/18/2017,110404,47336,30818,188558,69.62998523
12/19/2017,110176,47069,30854,188099,69.46048744
12/20/2017,109932,46958,30914,187804,69.35155096
12/21/2017,109721,46924,30887,187532,69.25110783
12/22/2017,109526,46858,30919,187303,69.16654357
12/23/2017,109283,46780,30980,187043,69.07053176
12/24/2017,109316,46869,31215,187400,69.20236337
12/25/2017,109251,47202,31364,187817,69.35635155
12/26/2017,109218,47469,31443,188130,69.47193501
12/27/2017,108959,47447,31053,187459,69.22415066
12/28/2017,108733,47347,30639,186719,68.95088626
12/29/2017,108508,47269,30236,186013,68.69017725
12/30/2017,108282,47369,29838,185489,68.49667651
12/31/2017,108040,47536,29441,185017,68.32237814
1/1/2018,107782,47669,29083,184534,68.14401773
1/2/2018,107476,47780,28690,183946,67.92688331
1/3/2018,107300,47925,28381,183606,67.80132939
1/4/2018,107156,48047,28084,183287,67.68353028
1/5/2018,107044,48170,27783,182997,67.57644018
1/6/2018,106900,48236,27460,182596,67.42836041
1/7/2018,106708,48236,27159,182103,67.24630724
1/8/2018,106532,48236,26970,181738,67.11152142
1/9/2018,106276,48314,27000,181590,67.05686854
1/10/2018,105988,48414,27000,181402,66.98744461
1/11/2018,105653,48514,27031,181198,66.91211226
1/12/2018,105478,48703,27094,181275,66.94054653
1/13/2018,107766,50811,29369,187946,69.40398818
1/14/2018,109705,53062,30396,193163,71.33050222
1/15/2018,110517,54217,30693,195427,72.16654357
1/16/2018,111089,55152,30914,197155,72.80465288
1/17/2018,111447,56104,31132,198683,73.36890694
1/18/2018,111644,56812,31299,199755,73.76477105
1/19/2018,111759,57325,31425,200509,74.04320532
1/20/2018,111824,57838,31560,201222,74.30649926
1/21/2018,111988,58339,31681,202008,74.59675037
1/22/2018,112102,58778,31808,202688,74.8478582
1/23/2018,112266,59389,31958,203613,75.1894387
1/24/2018,114230,62326,33019,209575,77.39106352
1/25/2018,115061,64033,33153,212247,78.37776957
1/26/2018,115742,65166,33101,214009,79.02843427
1/27/2018,116194,66057,33005,215256,79.48892171
1/28/2018,116846,66847,32895,216588,79.98079764
1/29/2018,117451,67609,32771,217831,80.43980798
1/30/2018,117888,68232,32615,218735,80.77363368
1/31/2018,118208,68762,32386,219356,81.00295421
2/1/2018,118579,69185,32222,219986,81.23559823
2/2/2018,118495,69609,32137,220241,81.32976366
2/3/2018,118293,69874,32000,220167,81.30243722
2/4/2018,118124,70112,32037,220273,81.3415805
2/5/2018,117972,70443,32127,220542,81.44091581
2/6/2018,117770,70682,32155,220607,81.46491876
2/7/2018,117551,70907,32160,220618,81.4689808
2/8/2018,117434,71132,32232,220798,81.53545052
2/9/2018,117199,71159,32260,220618,81.4689808
2/10/2018,116830,71119,32307,220256,81.33530281
2/11/2018,116763,71172,32368,220303,81.35265879
2/12/2018,117484,71569,32349,221402,81.75849335
2/13/2018,118208,72457,32373,223038,82.36262925
2/14/2018,118748,72854,32217,223819,82.65103397
2/15/2018,119240,73185,32037,224462,82.88847858
2/16/2018,119987,73954,31981,225922,83.42762186
2/17/2018,120855,75141,32292,228288,84.30132939
2/18/2018,121643,76675,32505,230823,85.23744461
2/19/2018,122138,77448,32647,232233,85.75812408
2/20/2018,122877,78498,32871,234246,86.5014771
2/21/2018,123739,80308,33062,237109,87.55871492
2/22/2018,124603,81871,33269,239743,88.53138848
2/23/2018,125175,83504,33331,242010,89.36853767
2/24/2018,126149,84849,33360,244358,90.23559823
2/25/2018,127250,86294,33693,247237,91.29874446
2/26/2018,128761,88057,34340,251158,92.74667651
2/27/2018,129731,89073,34660,253464,93.59822747
2/28/2018,130457,89667,34892,255016,94.17134417
3/1/2018,130972,90016,35036,256024,94.54357459
3/2/2018,131612,90351,35145,257108,94.94387001
3/3/2018,132237,90640,35125,258002,95.27400295
3/4/2018,132541,90686,35075,258302,95.38478582
3/5/2018,132718,90579,35060,258357,95.40509601
3/6/2018,132897,90397,34882,258176,95.33825702
3/7/2018,133078,90199,34670,257947,95.25369276
3/8/2018,133132,89956,34463,257551,95.10745938
3/9/2018,133168,89667,34219,257054,94.9239291
3/10/2018,133078,89302,33969,256349,94.66358936
3/11/2018,132862,88921,33756,255539,94.36447563
3/12/2018,132665,88465,33534,254664,94.04135894
3/13/2018,132629,88328,33355,254312,93.91137371
3/14/2018,132683,88632,33173,254488,93.97636632
3/15/2018,132629,89028,32972,254629,94.02843427
3/16/2018,132505,89362,32767,254634,94.03028065
3/17/2018,132237,89651,32557,254445,93.96048744
3/18/2018,132004,89910,32349,254263,93.89327917
3/19/2018,131702,90153,32132,253987,93.79135894
3/20/2018,131416,90382,31911,253709,93.68870015
3/21/2018,131096,90549,31747,253392,93.57163959
3/22/2018,130848,90655,31587,253090,93.46011817
3/23/2018,130546,90762,31378,252686,93.31093058
3/24/2018,130280,90640,31378,252298,93.1676514
3/25/2018,129890,90382,31420,251692,92.94387001
3/26/2018,129589,90153,31457,251199,92.76181684
3/27/2018,129253,89910,31490,250653,92.56019202
3/28/2018,129042,89499,31537,250078,92.3478582
3/29/2018,128778,88952,31620,249350,92.07902511
3/30/2018,129095,88921,31738,249754,92.2282127
3/31/2018,130635,90944,32056,253635,93.66137371
4/1/2018,131809,92755,32288,256852,94.8493353
4/2/2018,132773,94261,32496,259530,95.83825702
4/3/2018,133617,95402,32496,261515,96.57127031
4/4/2018,134444,96398,32596,263438,97.28138848
4/5/2018,135475,97122,32962,265559,98.06462334
4/6/2018,136417,97396,33211,267024,98.605613
4/7/2018,137255,97573,33437,268265,99.06388479
4/8/2018,137784,97540,33591,268915,99.30391433
4/9/2018,138149,97251,33736,269136,99.38552437
4/10/2018,138443,96945,33639,269027,99.34527326
4/11/2018,138590,96478,33751,268819,99.26846381
4/12/2018,138645,96060,33872,268577,99.17909897
4/13/2018,138682,95867,34008,268557,99.17171344
4/14/2018,138921,95770,34204,268895,99.2965288
4/15/2018,139509,95676,34557,269742,99.60930576
4/16/2018,140301,95615,34818,270734,99.97562777
4/17/2018,141894,96382,35369,273645,101.0505908
4/18/2018,141876,97122,35199,274197,101.2544313
4/19/2018,141543,97669,35135,274347,101.3098227
4/20/2018,141153,98088,35095,274336,101.3057607
4/21/2018,140820,98023,35075,273918,101.1514032
4/22/2018,140579,97396,35090,273065,100.8364106
4/23/2018,140320,96881,35090,272291,100.5505908
4/24/2018,140061,96446,35070,271577,100.2869276
4/25/2018,139951,96108,35095,271154,100.1307238
4/26/2018,140190,96527,35214,271931,100.4176514
4/27/2018,140320,96768,35155,272243,100.5328656
4/28/2018,140653,96929,35145,272727,100.7115953
4/29/2018,140727,96929,35145,272801,100.7389217
4/30/2018,140746,96848,35115,272709,100.7049483
5/1/2018,140597,96848,35090,272535,100.6406942
5/2/2018,140542,96768,35055,272365,100.5779173
5/3/2018,140468,96575,35060,272103,100.4811669
5/4/2018,140616,96478,35011,272105,100.4819055
5/5/2018,140634,96414,34956,272004,100.4446086
5/6/2018,140579,96285,34902,271766,100.3567208
5/7/2018,140505,96285,34843,271633,100.3076071
5/8/2018,140579,96205,34774,271558,100.2799114
5/9/2018,140542,96108,34675,271325,100.19387
5/10/2018,140431,96124,34552,271107,100.1133678
5/11/2018,140653,96189,34562,271404,100.2230428
5/12/2018,140486,96108,34621,271215,100.1532496
5/13/2018,140449,96076,34596,271121,100.1185377
5/14/2018,140357,96012,34695,271064,100.0974889
5/15/2018,140227,95835,34626,270688,99.95864106
5/16/2018,140412,95899,34645,270956,100.0576071
5/17/2018,140486,95947,34582,271015,100.0793944
5/18/2018,140653,95931,34626,271210,100.1514032
5/19/2018,140690,95867,34611,271168,100.1358936
5/20/2018,140968,96173,35060,272201,100.517356
5/21/2018,140857,96253,35145,272255,100.5372969
5/22/2018,140634,96221,35090,271945,100.4228213
5/23/2018,140431,96382,35070,271883,100.3999261
5/24/2018,140320,96382,35026,271728,100.3426883
5/25/2018,140171,96285,35026,271482,100.2518464
5/26/2018,139969,96140,35006,271115,100.116322
5/27/2018,139767,96044,34961,270772,99.98966027
5/28/2018,139712,96028,34764,270504,99.89069424
5/29/2018,139583,96044,34705,270332,99.82717873
5/30/2018,139418,95835,34715,269968,99.69276219
5/31/2018,139160,95523,34778,269461,99.50553914
6/1/2018,138070,92973,34503,265546,98.05982275
6/2/2018,137980,92851,34707,265538,98.05686854
6/3/2018,138100,92622,34572,265294,97.96676514
6/4/2018,138200,92409,34468,265077,97.8866322
6/5/2018,138140,92181,34374,264695,97.74556869
6/6/2018,138090,91923,34295,264308,97.60265879
6/7/2018,137980,91636,34290,263906,97.45420975
6/8/2018,137760,91515,34231,263506,97.30649926
6/9/2018,137540,91200,34147,262887,97.07791728
6/10/2018,137280,90854,34063,262197,96.82311669
6/11/2018,137030,90510,33980,261520,96.57311669
6/12/2018,136750,90166,33901,260817,96.31351551
6/13/2018,136480,89779,33798,260057,96.03286558
6/14/2018,136240,89451,33818,259509,95.83050222
6/15/2018,135950,89065,33818,258833,95.58087149
6/16/2018,135720,88724,33720,258164,95.3338257
6/17/2018,135370,88340,33573,257283,95.00849335
6/18/2018,134920,87853,33564,256337,94.65915805
6/19/2018,134560,87500,33573,255633,94.39918759
6/20/2018,134160,87147,33456,254763,94.07791728
6/21/2018,133670,86810,33277,253757,93.70642541
6/22/2018,133240,86415,33257,252912,93.394387
6/23/2018,132740,86021,33160,251921,93.02843427
6/24/2018,132430,85715,33150,251295,92.79726736
6/25/2018,132130,85497,33170,250797,92.6133678
6/26/2018,131680,85265,33049,249994,92.316839
6/27/2018,131200,84917,33005,249122,91.99483013
6/28/2018,131000,84758,33073,248831,91.88737075
6/29/2018,130880,84903,33228,249011,91.95384047
6/30/2018,130550,84932,33247,248729,91.84970458
7/1/2018,130140,84772,33247,248159,91.63921713
7/2/2018,129720,84397,33228,247345,91.33862629
7/3/2018,129260,84065,33199,246524,91.03545052
7/4/2018,128780,83821,33121,245722,90.73929099
7/5/2018,128280,83548,33088,244916,90.44165436
7/6/2018,127930,83275,33068,244273,90.20420975
7/7/2018,127540,83018,33063,243621,89.96344165
7/8/2018,127100,82704,33030,242834,89.67282127
7/9/2018,126640,82348,32996,241984,89.35893648
7/10/2018,126170,81978,32962,241110,89.03618907
7/11/2018,125660,81595,32938,240193,88.69756278
7/12/2018,125230,81228,32870,239328,88.37813885
7/13/2018,124700,80847,32832,238379,88.02769572
7/14/2018,124220,80565,32793,237578,87.73190547
7/15/2018,123900,80551,32769,237220,87.59970458
7/16/2018,123490,80270,32740,236500,87.3338257
7/17/2018,123000,79849,32707,235556,86.98522895
7/18/2018,122670,79737,32687,235094,86.81462334
7/19/2018,122210,79597,32649,234456,86.57902511
7/20/2018,121780,79318,32601,233699,86.29948301
7/21/2018,121280,78997,32562,232839,85.98190547
7/22/2018,120850,78690,32529,232069,85.69756278
7/23/2018,120760,78398,32658,231816,85.60413589
7/24/2018,121280,78510,33852,233642,86.27843427
7/25/2018,121900,78746,34781,235427,86.93759232
7/26/2018,125210,80017,35151,240378,88.76587888
7/27/2018,127470,81780,34946,244196,90.17577548
7/28/2018,129310,82490,34741,246541,91.04172821
7/29/2018,129950,82932,34562,247444,91.37518464
7/30/2018,130340,83132,34340,247812,91.51107829
7/31/2018,130090,83233,34098,247421,91.36669129
8/1/2018,129740,83275,33833,246848,91.15509601
8/2/2018,129880,83318,34652,247850,91.52511078
8/3/2018,129910,83390,34891,248191,91.65103397
8/4/2018,133710,84816,35256,253782,93.71565731
8/5/2018,136240,86328,35026,257594,95.12333826
8/6/2018,137450,87118,34926,259494,95.82496307
8/7/2018,137830,87456,34851,260137,96.06240768
8/8/2018,137880,87853,34786,260519,96.2034712
8/9/2018,139320,88961,34821,263102,97.15731167
8/10/2018,139960,89630,34801,264391,97.63330871
8/11/2018,139890,89719,34786,264395,97.63478582
8/12/2018,139960,90017,34821,264798,97.78360414
8/13/2018,139720,90002,34811,264533,97.68574594
8/14/2018,140740,89913,35166,265819,98.16063516
8/15/2018,141350,90914,34996,267260,98.69276219
8/16/2018,140940,91395,34891,267226,98.68020679
8/17/2018,140400,91515,34821,266736,98.49926145
8/18/2018,141530,92653,35386,269569,99.54542097
8/19/2018,142180,95445,35016,272641,100.6798375
8/20/2018,141480,95852,34901,272233,100.5291728
8/21/2018,140920,95570,34851,271341,100.1997784
8/22/2018,140370,95134,34816,270320,99.82274742
8/23/2018,140010,94745,34836,269591,99.55354505
8/24/2018,139720,94280,34806,268806,99.26366322
8/25/2018,139320,93817,34786,267923,98.93759232
8/26/2018,138840,93356,34766,266962,98.58271787
8/27/2018,138380,92866,34756,266002,98.2282127
8/28/2018,137810,92318,34741,264869,97.80982275
8/29/2018,137170,91561,34721,263452,97.28655835
8/30/2018,136610,90810,34687,262107,96.78988183
8/31/2018,135950,90211,34652,260813,96.3120384
9/1/2018,135280,89570,34637,259487,95.82237814
9/2/2018,134560,88991,34587,258138,95.32422452
9/3/2018,133910,88443,34409,256762,94.81610044
9/4/2018,133190,87897,34123,255210,94.24298375
9/5/2018,132470,87368,33813,253651,93.66728213
9/6/2018,131770,86840,33505,252115,93.10007386
9/7/2018,131340,86357,33247,250944,92.6676514
9/8/2018,130700,85847,32972,249519,92.14143279
9/9/2018,129970,85265,32856,248091,91.61410635
9/10/2018,129260,84714,32812,246786,91.13220089
9/11/2018,129200,84686,33218,247104,91.24963072
9/12/2018,128800,84512,33369,246681,91.09342688
9/13/2018,128340,84166,33510,246016,90.8478582
9/14/2018,128000,83893,33705,245598,90.69350074
9/15/2018,127540,83333,33813,244686,90.35672083
9/16/2018,127034,82716,33872,243622,89.96381093
9/17/2018,126450,81964,33896,242310,89.47932053
9/18/2018,126310,81482,34127,241919,89.33493353
9/19/2018,127030,81638,34931,243599,89.95531758
9/20/2018,126930,81553,34886,243369,89.87038405
9/21/2018,126560,81411,34826,242797,89.65915805
9/22/2018,126520,81638,34886,243044,89.75036928
9/23/2018,126490,81950,34876,243316,89.85081241
9/24/2018,126210,82063,34826,243099,89.77067947
9/25/2018,126210,82134,34831,243175,89.79874446
9/26/2018,127910,83361,35201,246472,91.01624815
9/27/2018,130200,84368,35161,249729,92.2189808
9/28/2018,132110,85120,35055,252285,93.16285081
9/29/2018,133982,86429,35029,255440,94.32791728
9/30/2018,135060,87030,34926,257016,94.9098966
10/1/2018,135789,87319,34895,258003,95.27437223
10/2/2018,136530,87441,34846,258817,95.57496307
10/3/2018,137900,88458,35031,261389,96.52474151
10/4/2018,138750,89035,34921,262706,97.01107829
10/5/2018,139390,89451,34891,263732,97.38995569
10/6/2018,139760,89600,34836,264196,97.56129985
10/7/2018,139740,89615,34821,264176,97.55391433
10/8/2018,139630,89511,34811,263952,97.47119645
10/9/2018,139540,89258,34801,263599,97.34084195
10/10/2018,139300,88932,34791,263023,97.12813885
10/11/2018,139320,88621,34771,262712,97.01329394
10/12/2018,139680,89006,34961,263647,97.35856721
10/13/2018,139680,89080,34891,263651,97.36004431
10/14/2018,139700,89124,34836,263660,97.3633678
10/15/2018,139630,89035,34821,263486,97.29911374
10/16/2018,139680,88961,34821,263462,97.29025111
10/17/2018,139440,88946,34811,263197,97.19239291
10/18/2018,139280,88798,34781,262859,97.06757755
10/19/2018,139080,88576,34771,262427,96.90805022
10/20/2018,138650,88266,34776,261692,96.6366322
10/21/2018,138250,88030,34766,261046,96.39807976
10/22/2018,137830,87691,34736,260257,96.10672083
10/23/2018,137280,87294,34741,259315,95.75886263
10/24/2018,136680,86854,34731,258265,95.3711226
10/25/2018,136130,86255,34662,257047,94.92134417
10/26/2018,135550,85541,34657,255748,94.44165436
10/27/2018,134920,85048,34577,254545,93.99741507
10/28/2018,134892,84967,34739,254598,94.01698671
10/29/2018,134749,84981,34814,254544,93.99704579
10/30/2018,134540,84772,34814,254126,93.84268833
10/31/2018,134374,84440,34804,253618,93.65509601
11/1/2018,134100,84022,34771,252893,93.38737075
11/2/2018,134030,83663,34786,252479,93.2344904
11/3/2018,135390,84080,35106,254576,94.00886263
11/4/2018,137210,85033,34986,257229,94.98855244
11/5/2018,138100,85570,34916,258586,95.48966027
11/6/2018,138710,86138,34921,259769,95.92651403
11/7/2018,139480,86810,35031,261321,96.49963072
11/8/2018,139740,87177,34941,261858,96.69793205
11/9/2018,139870,87353,34871,262094,96.78508124
11/10/2018,140240,87765,34941,262946,97.09970458
11/11/2018,140220,88414,34896,263530,97.31536189
11/12/2018,140070,88665,34851,263586,97.33604136
11/13/2018,140000,88858,34861,263719,97.3851551
11/14/2018,139960,89288,34901,264149,97.54394387
11/15/2018,139830,89421,34851,264102,97.52658789
11/16/2018,139830,89570,34876,264276,97.59084195
11/17/2018,139680,89555,34826,264061,97.51144756
11/18/2018,139550,89466,34811,263827,97.42503693
11/19/2018,139430,89258,34816,263504,97.30576071
11/20/2018,139350,89095,34821,263266,97.21787297
11/21/2018,139210,88858,34816,262884,97.07680945
11/22/2018,139080,88561,34776,262417,96.90435746
11/23/2018,138870,88133,34751,261754,96.65952733
11/24/2018,138670,87647,34756,261073,96.40805022
11/25/2018,138800,87456,34861,261117,96.42429838
11/26/2018,139080,87514,34911,261505,96.56757755
11/27/2018,139960,88059,35096,263115,97.16211226
11/28/2018,140290,88843,34966,264099,97.52548006
11/29/2018,140140,89273,34886,264299,97.5993353
11/30/2018,139960,89496,34836,264292,97.59675037
12/1/2018,139852,89569,34819,264240,97.57754801
12/2/2018,139782,89649,34829,264260,97.58493353
12/3/2018,139982,90289,34929,265200,97.93205318
12/4/2018,140162,91019,34899,266080,98.25701625
12/5/2018,140162,91529,34859,266550,98.43057607
12/6/2018,139922,91799,34829,266550,98.43057607
12/7/2018,139702,91919,34819,266440,98.38995569
12/8/2018,139502,91909,34799,266210,98.30502216
12/9/2018,139352,91759,34789,265900,98.19054653
12/10/2018,139022,91469,34779,265270,97.95790251
12/11/2018,138712,91189,34769,264670,97.73633678
12/12/2018,138322,90769,34749,263840,97.42983752
12/13/2018,137872,90379,34739,262990,97.11595273
12/14/2018,137302,89899,34739,261940,96.7282127
12/15/2018,136792,89439,34729,260960,96.36632201
12/16/2018,136302,89019,34749,260070,96.03766617
12/17/2018,135952,88709,34799,259460,95.81240768
12/18/2018,135442,88269,34739,258450,95.4394387
12/19/2018,134812,87789,34689,257290,95.01107829
12/20/2018,134212,87289,34689,256190,94.60487445
12/21/2018,134342,86989,34899,256230,94.61964549
12/22/2018,136552,88049,35399,260000,96.01181684
12/23/2018,138052,88859,35039,261950,96.73190547
12/24/2018,138972,89329,34929,263230,97.20457903
12/25/2018,139552,89599,34869,264020,97.49630724
12/26/2018,139832,89659,34819,264310,97.60339734
12/27/2018,139902,89569,34819,264290,97.59601182
12/28/2018,139922,89409,34809,264140,97.54062038
12/29/2018,140032,89409,34899,264340,97.61447563
12/30/2018,140012,89299,34849,264160,97.54800591
12/31/2018,139942,89099,34829,263870,97.44091581
1/1/2019,140132,88989,34939,264060,97.51107829
1/2/2019,140032,89199,34929,264160,97.54800591
1/3/2019,139922,89149,34849,263920,97.45937962
1/4/2019,139902,89069,34829,263800,97.41506647
1/5/2019,139682,88949,34819,263450,97.28581979
1/6/2019,139722,88929,34869,263520,97.31166913
1/7/2019,139442,88869,34829,263140,97.17134417
1/8/2019,139042,88579,34819,262440,96.91285081
1/9/2019,138912,88439,34829,262180,96.816839
1/10/2019,138752,88429,34779,261960,96.73559823
1/11/2019,138432,88239,34739,261410,96.53249631
1/12/2019,138012,87849,34709,260570,96.22230428
1/13/2019,137592,87339,34719,259650,95.88257016
1/14/2019,137082,86679,34729,258490,95.45420975
1/15/2019,136572,85959,34719,257250,94.99630724
1/16/2019,136022,85499,34709,256230,94.61964549
1/17/2019,135482,85019,34699,255200,94.23929099
1/18/2019,134922,84479,34689,254090,93.82939439
1/19/2019,134432,83949,34669,253050,93.44534712
1/20/2019,134272,83479,34689,252440,93.22008863
1/21/2019,133942,82919,34699,251560,92.89512555
1/22/2019,133602,82249,34649,250500,92.50369276
1/23/2019,133042,81599,34629,249270,92.04948301
1/24/2019,133262,81359,34699,249320,92.06794682
1/25/2019,138272,85049,35229,258550,95.47636632
1/26/2019,139962,87469,34939,262370,96.88700148
1/27/2019,140462,88469,34859,263790,97.41137371
1/28/2019,140402,88979,34819,264200,97.56277696
1/29/2019,139942,89189,34789,263920,97.45937962
1/30/2019,139682,89189,34799,263670,97.36706056
1/31/2019,139302,88869,34769,262940,97.09748892
2/1/2019,138932,88399,34769,262100,96.7872969
2/2/2019,138512,87939,34729,261180,96.44756278
2/3/2019,138122,87529,34739,260390,96.15583456
2/4/2019,137762,87209,34739,259710,95.90472674
2/5/2019,137452,86959,34749,259160,95.70162482
2/6/2019,137432,87279,34789,259500,95.82717873
2/7/2019,137722,87679,34799,260200,96.08567208
2/8/2019,138752,88959,34939,262650,96.99039882
2/9/2019,140142,91349,34969,266460,98.39734121
2/10/2019,140372,92429,34899,267700,98.85524372
2/11/2019,140292,92999,34849,268140,99.01772526
2/12/2019,140052,93329,34829,268210,99.04357459
2/13/2019,139942,93489,34819,268250,99.05834564
2/14/2019,139742,93479,34789,268010,98.96971935
2/15/2019,139612,93329,34779,267720,98.86262925
2/16/2019,139432,93139,34779,267350,98.72599705
2/17/2019,139282,92899,34759,266940,98.5745938
2/18/2019,139042,92549,34769,266360,98.36041359
2/19/2019,138752,92109,34749,265610,98.08345643
2/20/2019,138312,91559,34739,264610,97.71418021
2/21/2019,137992,91079,34729,263800,97.41506647
2/22/2019,137662,90619,34729,263010,97.12333826
2/23/2019,137262,90079,34719,262060,96.77252585
2/24/2019,136922,89529,34719,261170,96.44387001
2/25/2019,136612,89199,34779,260590,96.22968981
2/26/2019,136222,88799,34749,259770,95.92688331
2/27/2019,135792,88249,34729,258770,95.55760709
2/28/2019,135322,87689,34679,257690,95.15878877
3/1/2019,134902,87159,34669,256730,94.8042836
3/2/2019,134472,86669,34649,255790,94.45716396
3/3/2019,134002,86329,34629,254960,94.1506647
3/4/2019,133582,86109,34589,254280,93.89955687
3/5/2019,133102,85919,34559,253580,93.64106352
3/6/2019,132562,85719,34509,252790,93.3493353
3/7/2019,132022,85589,34459,252070,93.08345643
3/8/2019,131482,85429,34409,251320,92.80649926
3/9/2019,130932,85309,34349,250590,92.53692762
3/10/2019,130472,85249,34329,250050,92.33751846
3/11/2019,129972,85149,34289,249410,92.10118168
3/12/2019,129562,85109,34239,248910,91.91654357
3/13/2019,129012,85059,34189,248260,91.67651403
3/14/2019,128602,84989,34139,247730,91.48079764
3/15/2019,128372,85209,34099,247680,91.46233383
3/16/2019,128552,86299,34269,249120,91.99409158
3/17/2019,128652,87179,34349,250180,92.38552437
3/18/2019,128812,87839,34359,251010,92.69202363
3/19/2019,129082,88329,34329,251740,92.96159527
3/20/2019,129192,88709,34279,252180,93.12407681
3/21/2019,129522,88989,34229,252740,93.33087149
3/22/2019,130072,89449,34329,253850,93.74076809
3/23/2019,130662,89819,34499,254980,94.15805022
3/24/2019,131042,89939,34569,255550,94.36853767
3/25/2019,131502,89989,34609,256100,94.57163959
3/26/2019,131842,90049,34669,256560,94.74150665
3/27/2019,132072,90079,34649,256800,94.83013294
3/28/2019,132432,90049,34659,257140,94.95568685
3/29/2019,132792,90079,34689,257560,95.11078287
3/30/2019,133512,90499,34799,258810,95.57237814
3/31/2019,134302,91119,34939,260360,96.14475628
4/1/2019,135372,91739,34979,262090,96.78360414
4/2/2019,136262,92149,34909,263320,97.23781388
4/3/2019,137032,92349,34839,264220,97.57016248
4/4/2019,137562,92489,34839,264890,97.81757755
4/5/2019,137872,92469,34829,265170,97.92097489
4/6/2019,138162,92429,34829,265420,98.01329394
4/7/2019,138322,92349,34859,265530,98.05391433
4/8/2019,138472,92289,34939,265700,98.11669129
4/9/2019,138562,92289,35009,265860,98.17577548
4/10/2019,138642,92449,34979,266070,98.25332349
4/11/2019,138842,92729,34919,266490,98.4084195
4/12/2019,139132,92969,34859,266960,98.58197932
4/13/2019,139572,93069,34999,267640,98.83308715
4/14/2019,139902,93029,35009,267940,98.94387001
4/15/2019,141942,93489,35399,270830,100.0110783
4/16/2019,142432,95349,35109,272890,100.7717873
4/17/2019,141462,95679,34979,272120,100.4874446
4/18/2019,140852,95479,34909,271240,100.1624815
4/19/2019,140442,95169,34869,270480,99.88183161
4/20/2019,140552,95729,34969,271250,100.1661743
4/21/2019,141532,96479,35159,273170,100.8751846
4/22/2019,141052,96249,34989,272290,100.5502216
4/23/2019,140552,95819,34929,271300,100.1846381
4/24/2019,140142,95369,34899,270410,99.85598227
4/25/2019,139782,94989,34849,269620,99.56425406
4/26/2019,139682,94589,34839,269110,99.37592319
4/27/2019,139962,94749,34949,269660,99.57902511
4/28/2019,139922,94959,34909,269790,99.62703102
4/29/2019,139782,94889,34899,269570,99.54579025
4/30/2019,139762,94699,34859,269320,99.4534712
5/1/2019,139652,94529,34849,269030,99.34638109
5/2/2019,139392,94279,34839,268510,99.15435746
5/3/2019,139212,94019,34829,268060,98.98818316
5/4/2019,139352,93939,34839,268130,99.0140325
5/5/2019,139412,93989,34849,268250,99.05834564
5/6/2019,139462,93959,34859,268280,99.06942393
5/7/2019,139212,93819,34849,267880,98.92171344
5/8/2019,139062,93479,34839,267380,98.73707533
5/9/2019,138892,93079,34779,266750,98.50443131
5/10/2019,138622,92699,34769,266090,98.26070901
5/11/2019,138362,92389,34789,265540,98.05760709
5/12/2019,137992,92079,34779,264850,97.8028065
5/13/2019,138252,92119,34889,265260,97.95420975
5/14/2019,138952,92879,34949,266780,98.5155096
5/15/2019,139502,93859,34919,268280,99.06942393
5/16/2019,139832,94339,34859,269030,99.34638109
5/17/2019,139792,94479,34669,268940,99.31314623
5/18/2019,139762,94469,34769,269000,99.33530281
5/19/2019,139572,94229,34789,268590,99.18389956
5/20/2019,139432,94449,34839,268720,99.23190547
5/21/2019,139392,95039,34819,269250,99.42762186
5/22/2019,139082,94809,34799,268690,99.22082718
5/23/2019,138542,94509,34789,267840,98.90694239
5/24/2019,138122,94169,34799,267090,98.62998523
5/25/2019,138072,93819,34779,266670,98.47488922
5/26/2019,138072,93759,34779,266610,98.45273264
5/27/2019,138092,93759,34769,266620,98.45642541
5/28/2019,137992,93589,34749,266330,98.3493353
5/29/2019,137902,93649,34769,266320,98.34564254
5/30/2019,137902,93679,34819,266400,98.37518464
5/31/2019,137882,93799,34799,266480,98.40472674
6/1/2019,137832,93759,34759,266350,98.35672083
6/2/2019,137992,93619,34749,266360,98.36041359
6/3/2019,138232,93539,34729,266500,98.41211226
6/4/2019,138422,93369,34669,266460,98.39734121
6/5/2019,138432,93079,34589,266100,98.26440177
6/6/2019,138652,92839,34529,266020,98.23485968
6/7/2019,138732,92779,34479,265990,98.22378139
6/8/2019,138862,92619,34489,265970,98.21639586
6/9/2019,138932,92409,34489,265830,98.16469719
6/10/2019,138912,92139,34459,265510,98.0465288
6/11/2019,139432,92139,34759,266330,98.3493353
6/12/2019,139412,92549,34819,266780,98.5155096
6/13/2019,139192,92639,34709,266540,98.42688331
6/14/2019,139152,92809,34729,266690,98.48227474
6/15/2019,139132,92749,34709,266590,98.44534712
6/16/2019,139082,92619,34749,266450,98.39364845
6/17/2019,139572,93109,34809,267490,98.77769572
6/18/2019,139672,93389,34809,267870,98.91802068
6/19/2019,139482,93489,34749,267720,98.86262925
6/20/2019,139172,93139,34729,267040,98.61152142
6/21/2019,139092,92709,34829,266630,98.46011817
6/22/2019,139222,92529,34819,266570,98.4379616
6/23/2019,138972,92059,34769,265800,98.15361891
6/24/2019,138602,91459,34739,264800,97.78434269
6/25/2019,138162,90899,34739,263800,97.41506647
6/26/2019,137682,90589,34799,263070,97.14549483
6/27/2019,137502,90419,34659,262580,96.96454948
6/28/2019,137122,90299,34559,261980,96.74298375
6/29/2019,136682,90199,34419,261300,96.49187592
6/30/2019,136302,90169,34289,260760,96.29246677
7/1/2019,136012,90109,34129,260250,96.10413589
7/2/2019,135702,89999,33959,259660,95.88626292
7/3/2019,135332,89849,33819,259000,95.64254062
7/4/2019,135102,89529,33659,258290,95.38035451
7/5/2019,134862,89129,33519,257510,95.09231905
7/6/2019,134652,88649,33369,256670,94.78212703
7/7/2019,134432,88239,33269,255940,94.51255539
7/8/2019,134142,87789,33149,255080,94.19497784
7/9/2019,133852,87339,32989,254180,93.86262925
7/10/2019,133492,86799,32879,253170,93.48966027
7/11/2019,133102,86259,32839,252200,93.13146233
7/12/2019,132792,85799,32759,251350,92.81757755
7/13/2019,132402,85369,32609,250380,92.45937962
7/14/2019,131952,84929,32579,249460,92.11964549
7/15/2019,131522,84589,32529,248640,91.816839
7/16/2019,131042,84069,32499,247610,91.43648449
7/17/2019,130542,83589,32399,246530,91.03766617
7/18/2019,130382,83609,32289,246280,90.94534712
7/19/2019,130072,83519,32299,245890,90.80132939
7/20/2019,129752,83019,32129,244900,90.43574594
7/21/2019,129382,82489,31923,243794,90.02732644
7/22/2019,128942,81979,31738,242659,89.60819793
7/23/2019,128882,81939,31790,242611,89.59047267
7/24/2019,128652,81719,31771,242142,89.41728213
7/25/2019,128322,81299,31747,241368,89.13146233
7/26/2019,127952,80819,31705,240476,88.80206795
7/27/2019,127542,80309,31681,239532,88.4534712
7/28/2019,127122,79749,31639,238510,88.0760709
7/29/2019,126782,79249,31511,237542,87.71861152
7/30/2019,126362,78679,31356,236397,87.29579025
7/31/2019,125912,78189,31192,235293,86.88810931
8/1/2019,125542,77749,31140,234431,86.56979321
8/2/2019,125102,77279,31084,233465,86.21307238
8/3/2019,124652,76779,31028,232459,85.8415805
8/4/2019,124322,76339,30972,231633,85.53655835
8/5/2019,123922,75929,30930,230781,85.22193501
8/6/2019,123472,75469,30864,229805,84.86152142
8/7/2019,123162,75229,30930,229321,84.68279173
8/8/2019,122862,74869,30925,228656,84.43722304
8/9/2019,122712,74489,30883,228084,84.22599705
8/10/2019,122332,74069,30836,227237,83.91322009
8/11/2019,121982,73609,30780,226371,83.59342688
8/12/2019,121552,73149,30720,225421,83.24261448
8/13/2019,121002,72669,30655,224326,82.83825702
8/14/2019,120492,72209,30604,223305,82.461226
8/15/2019,120032,71749,30543,222324,82.09896603
8/16/2019,119582,71379,30492,221453,81.77732644
8/17/2019,119172,70919,30460,220551,81.44423929
8/18/2019,118872,70499,30428,219799,81.16654357
8/19/2019,118612,70119,30330,219061,80.89401773
8/20/2019,118122,69749,30178,218049,80.52031019
8/21/2019,117632,69279,29967,216878,80.08788774
8/22/2019,117272,68839,29875,215986,79.75849335
8/23/2019,116882,68509,29656,215047,79.41174298
8/24/2019,116462,68069,29610,214141,79.07717873
8/25/2019,115972,67529,29551,213052,78.67503693
8/26/2019,115522,66989,29487,211998,78.28581979
8/27/2019,115052,66539,29423,211014,77.92245199
8/28/2019,114512,66049,29360,209921,77.51883309
8/29/2019,114112,65519,29274,208905,77.14364845
8/30/2019,113662,64999,29143,207804,76.73707533
8/31/2019,113202,64379,28980,206561,76.27806499
9/1/2019,112682,63749,28917,205348,75.83013294
9/2/2019,112232,63209,28859,204300,75.44313146
9/3/2019,111872,62889,28832,203593,75.18205318
9/4/2019,111492,62389,28787,202668,74.84047267
9/5/2019,111062,61829,28724,201615,74.45162482
9/6/2019,110622,61169,28666,200457,74.02400295
9/7/2019,110142,60659,28599,199400,73.63367799
9/8/2019,109632,60069,28545,198246,73.20753323
9/9/2019,109192,59309,28496,196997,72.74630724
9/10/2019,108702,58549,28434,195685,72.26181684
9/11/2019,108312,57749,28269,194330,71.76144756
9/12/2019,107922,57049,28225,193196,71.34268833
9/13/2019,107512,56429,28185,192126,70.94756278
9/14/2019,107032,55689,28127,190848,70.47562777
9/15/2019,106582,54969,28101,189652,70.03397341
9/16/2019,106122,54289,28048,188459,69.59342688
9/17/2019,105642,53599,27986,187227,69.13847858
9/18/2019,105102,52959,27920,185981,68.67836041
9/19/2019,104602,52369,27876,184847,68.25960118
9/20/2019,104142,51769,27660,183571,67.78840473
9/21/2019,103632,51299,27380,182311,67.32311669
9/22/2019,103122,50749,27101,180972,66.82865583
9/23/2019,102662,50229,26811,179702,66.35967504
9/24/2019,102262,49709,26544,178515,65.92134417
9/25/2019,101792,49249,26261,177302,65.47341211
9/26/2019,101322,48749,25976,176047,65.00997046
9/27/2019,100912,48329,25721,174962,64.60930576
9/28/2019,100442,47779,25439,173660,64.12850812
9/29/2019,99952,47069,25171,172192,63.58641064
9/30/2019,99052,46439,24887,170378,62.91654357
10/1/2019,99052,45879,24618,169549,62.61041359
10/2/2019,98592,45409,24351,168352,62.16838996
10/3/2019,98172,45069,24090,167331,61.79135894
10/4/2019,97882,44709,23867,166458,61.4689808
10/5/2019,97462,44229,23624,165315,61.04689808
10/6/2019,97012,43769,23363,164144,60.61447563
10/7/2019,96622,43609,23140,163371,60.32902511
10/8/2019,96522,43709,23036,163267,60.29062038
10/9/2019,96112,43609,23088,162809,60.12149188
10/10/2019,95792,43149,23036,161977,59.81425406
10/11/2019,95402,42649,23016,161067,59.4782127
10/12/2019,95022,42239,22996,160257,59.17909897
10/13/2019,94622,41839,22977,159438,58.87666174
10/14/2019,94222,41179,22957,158358,58.47784343
10/15/2019,93812,40699,22873,157384,58.11816839
10/16/2019,93352,40349,22798,156499,57.79135894
10/17/2019,94462,40809,23236,158507,58.53286558
10/18/2019,96192,42589,23677,162458,59.99187592
10/19/2019,96832,43489,23846,164167,60.62296898
10/20/2019,97172,43919,23939,165030,60.94165436
10/21/2019,97312,44169,24004,165485,61.10967504
10/22/2019,97272,44339,24061,165672,61.17872969
10/23/2019,97322,44559,24175,166056,61.32053176
10/24/2019,97402,45109,24339,166850,61.61373708
10/25/2019,97432,45519,24433,167384,61.81093058
10/26/2019,97382,45899,24511,167792,61.96159527
10/27/2019,97342,46269,24589,168200,62.11225997
10/28/2019,97692,46979,24995,169666,62.65361891
10/29/2019,98092,47599,25200,170891,63.10598227
10/30/2019,98522,48069,25346,171937,63.4922452
10/31/2019,99072,48339,25510,172921,63.855613
11/1/2019,101132,50019,27713,178864,66.05022157
11/2/2019,103452,54149,28908,186509,68.87333826
11/3/2019,104852,56219,29342,190413,70.31499261
11/4/2019,105832,57589,29605,193026,71.27991137
11/5/2019,106592,58609,29802,195003,72.00997046
11/6/2019,107062,59429,29815,196306,72.49113737
11/7/2019,107582,60089,29751,197422,72.90324963
11/8/2019,107742,60729,29902,198373,73.25443131
11/9/2019,107762,61279,30003,199044,73.50221566
11/10/2019,107662,61719,30086,199467,73.6584195
11/11/2019,107552,62119,30164,199835,73.79431315
11/12/2019,107452,62509,30247,200208,73.93205318
11/13/2019,107302,62569,30303,200174,73.91949778
11/14/2019,107092,62549,30349,199990,73.85155096
11/15/2019,106882,62499,30395,199776,73.77252585
11/16/2019,106692,62419,30432,199543,73.68648449
11/17/2019,106492,62349,30478,199319,73.60376662
11/18/2019,106302,62229,30525,199056,73.50664697
11/19/2019,106302,62169,30571,199042,73.5014771
11/20/2019,106352,62359,30738,199449,73.65177253
11/21/2019,106352,62459,30818,199629,73.71824225
11/22/2019,106402,62509,30776,199687,73.73966027
11/23/2019,106532,62599,30664,199795,73.7795421
11/24/2019,106672,62779,30752,200203,73.93020679
11/25/2019,107032,63109,31079,201220,74.30576071
11/26/2019,107402,63469,31262,202133,74.6429099
11/27/2019,107712,63849,31412,202973,74.95310192
11/28/2019,108152,64259,31582,203993,75.32976366
11/29/2019,108652,64819,31743,205214,75.78064993
11/30/2019,109082,65269,31733,206084,76.10192024
12/1/2019,112888,66588,32091,211567,78.12666174
12/2/2019,113328,67014,32020,212362,78.42023634
12/3/2019,113678,67440,32063,213181,78.72267356
12/4/2019,114018,67906,32091,214015,79.03064993
12/5/2019,114198,68179,32138,214515,79.21528804
12/6/2019,114368,68348,32166,214882,79.35081241
12/7/2019,114478,68478,32072,215028,79.40472674
12/8/2019,114598,68543,31954,215095,79.42946824
12/9/2019,114648,68556,31836,215040,79.40915805
12/10/2019,115748,69105,32271,217124,80.17872969
12/11/2019,118148,72032,32761,222941,82.32680945
12/12/2019,119658,74052,32890,226600,83.67799114
12/13/2019,120608,75471,32928,229007,84.566839
12/14/2019,121498,76643,33053,231194,85.37444609
12/15/2019,122708,78249,33801,234758,86.69054653
12/16/2019,123478,79593,34103,237174,87.58271787
12/17/2019,124148,80654,34235,239037,88.27067947
12/18/2019,124628,81651,34284,240563,88.83419498
12/19/2019,124898,82131,34255,241284,89.10044313
12/20/2019,125248,82427,34171,241846,89.30797637
12/21/2019,125328,82611,34015,241954,89.3478582
12/22/2019,125348,82767,33961,242076,89.3929099
12/23/2019,125348,82938,33908,242194,89.43648449
12/24/2019,125368,83009,33777,242154,89.42171344
12/25/2019,125328,82952,33602,241882,89.32127031
12/26/2019,125278,82781,33457,241516,89.18611521
12/27/2019,125208,82569,33303,241080,89.02511078
12/28/2019,125208,82484,33158,240850,88.94017725
12/29/2019,125318,82470,33005,240793,88.91912851
12/30/2019,125518,82484,32923,240925,88.96787297
12/31/2019,126088,83137,32957,242182,89.43205318
1/1/2020,126248,83649,32851,242748,89.64106352
1/2/2020,126628,84135,32741,243504,89.92023634
1/3/2020,126918,84536,32603,244057,90.12444609
1/4/2020,127438,84680,32479,244597,90.32385524
1/5/2020,127928,84881,32422,245231,90.55797637
1/6/2020,128368,84967,32299,245634,90.70679468
1/7/2020,128728,84996,32157,245881,90.79800591
1/8/2020,128838,84924,32138,245900,90.80502216
1/9/2020,129058,84780,31968,245806,90.77031019
1/10/2020,129338,84522,31803,245663,90.71750369
1/11/2020,129398,84335,31761,245494,90.65509601
1/12/2020,129608,84321,31907,245836,90.78138848
1/13/2020,130248,84493,32399,247140,91.26292467
1/14/2020,130588,84493,32451,247532,91.40768095
1/15/2020,131198,84407,32413,248018,91.58714919
1/15/2020,130868,84450,32451,247769,91.49519941
1/16/2020,131468,84364,32337,248169,91.6429099
1/16/2020,131198,84407,32413,248018,91.58714919
1/17/2020,131538,84092,32204,247834,91.51920236
1/17/2020,131468,84364,32337,248169,91.6429099
1/18/2020,131538,84092,32204,247834,91.51920236
1/19/2020,131578,83749,32228,247555,91.4161743
1/20/2020,131578,83464,32261,247303,91.32311669
1/21/2020,131518,83080,32143,246741,91.11558346
1/22/2020,131348,82611,32025,245984,90.83604136
1/23/2020,130888,82258,31987,245133,90.5217873
1/24/2020,130688,81905,31973,244566,90.31240768
1/25/2020,130498,81721,31954,244173,90.16728213
1/26/2020,130658,82003,32114,244775,90.38958641
1/27/2020,130758,82272,32200,245230,90.55760709
1/28/2020,130708,82371,32233,245312,90.58788774
1/29/2020,130518,82356,32218,245092,90.50664697
1/30/2020,130358,82131,32200,244689,90.35782866
1/31/2020,130168,81764,32176,244108,90.14327917
2/1/2020,129988,81412,32162,243562,89.94165436
2/2/2020,129918,81061,32143,243122,89.77917282
2/3/2020,129848,80696,32114,242658,89.60782866
2/4/2020,129748,80319,32091,242158,89.42319055
2/5/2020,129538,79928,32067,241533,89.19239291
2/6/2020,129468,79635,31926,241029,89.0062777
2/7/2020,129498,79496,31818,240812,88.92614476
2/8/2020,130888,80878,31949,243715,89.99815362
2/9/2020,131498,81482,32034,245014,90.47784343
2/10/2020,131838,81736,31959,245533,90.66949778
2/11/2020,131928,81876,31879,245683,90.72488922
2/12/2020,132228,82003,31752,245983,90.83567208
2/13/2020,132638,82003,31803,246444,91.00590842
2/14/2020,132868,81961,31865,246694,91.09822747
2/15/2020,132938,81665,31634,246237,90.92946824
2/16/2020,133008,81384,31611,246003,90.84305761
2/17/2020,133058,81313,31620,245991,90.83862629
2/18/2020,132968,81201,31611,245780,90.76070901
2/19/2020,132798,81215,31630,245643,90.71011817
2/20/2020,132668,81299,31527,245494,90.65509601
2/21/2020,132408,81327,31265,245000,90.47267356
2/22/2020,132158,81356,31168,244682,90.35524372
2/23/2020,131978,81356,31205,244539,90.30243722
2/24/2020,131728,81384,31228,244340,90.22895126
2/25/2020,131518,81426,31261,244205,90.17909897
2/26/2020,131348,81538,31312,244198,90.17651403
2/27/2020,131428,81975,31475,244878,90.42762186
2/28/2020,131728,83051,31761,246540,91.04135894
2/29/2020,131958,83720,31733,247411,91.36299852
3/1/2020,131978,84221,31808,248007,91.58308715
3/2/2020,132048,84651,31888,248587,91.79726736
3/3/2020,131998,85126,31982,249106,91.98892171
3/4/2020,132248,85892,32200,250340,92.44460857
3/5/2020,132498,86487,32413,251398,92.83530281
3/6/2020,132758,86938,32560,252256,93.1521418
3/7/2020,132988,87244,32551,252783,93.34675037
3/8/2020,133188,87390,32636,253214,93.50590842
3/9/2020,133288,87463,32722,253473,93.60155096
3/10/2020,133668,87565,32832,254065,93.82016248
3/11/2020,133858,87946,33009,254813,94.09638109
3/12/2020,134328,88313,33163,255804,94.46233383
3/13/2020,134828,88607,33178,256613,94.76107829
3/14/2020,135378,88961,33641,257980,95.26587888
3/15/2020,135918,89094,33869,258881,95.59859675
3/16/2020,136238,89138,34035,259411,95.79431315
3/17/2020,136548,89182,33961,259691,95.89771049
3/18/2020,136818,89153,34074,260045,96.02843427
3/19/2020,137248,89138,34083,260469,96.18500739
3/20/2020,137648,89552,34240,261440,96.54357459
3/21/2020,138058,89996,34436,262490,96.93131462
3/22/2020,138348,90323,34658,263329,97.24113737
3/23/2020,138588,90590,34811,263989,97.48485968
3/24/2020,138858,90888,34830,264576,97.70162482
3/25/2020,138878,91202,34801,264881,97.81425406
3/26/2020,139108,91471,34924,265503,98.04394387
3/27/2020,139198,91711,34939,265848,98.17134417
3/28/2020,139288,91890,34924,266102,98.26514032
3/29/2020,139548,92236,35143,266927,98.56979321
3/30/2020,139878,92703,35267,267848,98.9098966
3/31/2020,140498,93234,35277,269009,99.33862629
4/1/2020,140618,93675,35247,269540,99.53471196
4/2/2020,141128,93950,35282,270360,99.83751846
4/3/2020,141498,94118,35257,270873,100.0269572
4/4/2020,141808,94210,35262,271280,100.1772526
4/5/2020,142118,94195,35257,271570,100.2843427
4/6/2020,142248,93980,35247,271475,100.2492614
4/7/2020,142228,93690,35202,271120,100.1181684
4/8/2020,142118,93462,35207,270787,99.99519941
4/9/2020,141978,93143,35207,270328,99.82570162
4/10/2020,141918,92900,35282,270100,99.74150665
4/11/2020,141808,92703,35237,269748,99.61152142
4/12/2020,141628,92416,35232,269276,99.43722304
4/13/2020,141778,92131,35277,269186,99.40398818
4/14/2020,143758,92718,35867,272343,100.5697932
4/15/2020,143978,93158,35457,272593,100.6621123
4/16/2020,143818,93401,35377,272596,100.6632201
4/17/2020,143498,93523,35332,272353,100.573486
4/18/2020,143358,93584,35297,272239,100.5313885
4/19/2020,143208,93568,35307,272083,100.4737814
4/20/2020,143038,93492,35312,271842,100.3847858
4/21/2020,142818,93340,35227,271385,100.2160266
4/22/2020,142558,93127,35217,270902,100.0376662
4/23/2020,142288,92915,35068,270271,99.80465288
4/24/2020,142008,92628,35019,269655,99.57717873
4/25/2020,141758,92311,34984,269053,99.35487445
4/26/2020,141408,91935,34939,268282,99.07016248
4/27/2020,141958,92131,35083,269172,99.39881832
4/28/2020,142488,92673,35038,270199,99.77806499
4/29/2020,142878,93173,34880,270931,100.0483752
4/30/2020,143318,93523,34875,271716,100.338257
5/1/2020,144408,94333,35657,274398,101.3286558
5/2/2020,145208,95925,35617,276750,102.1971935
5/3/2020,144778,96330,35437,276545,102.1214919
5/4/2020,144368,96267,35367,276002,101.9209749
5/5/2020,143838,96002,35252,275092,101.5849335
5/6/2020,143448,95832,35158,274438,101.3434269
5/7/2020,143118,96034,35098,274250,101.274003
5/8/2020,142948,96002,35033,273983,101.1754062
5/9/2020,142908,95645,34964,273517,101.0033235
5/10/2020,142858,95335,35058,273251,100.905096
5/11/2020,142788,95010,35019,272817,100.7448301
5/12/2020,142638,94640,35118,272396,100.5893648
5/13/2020,142468,94363,34989,271820,100.3766617
5/14/2020,142248,94103,34880,271231,100.1591581
5/15/2020,142108,93843,34830,270781,99.99298375
5/16/2020,142448,93904,34949,271301,100.1850074
5/17/2020,142438,94011,35033,271482,100.2518464
5/18/2020,142288,93767,34910,270965,100.0609306
5/19/2020,142118,93599,34890,270607,99.92872969
5/20/2020,141938,93523,34929,270390,99.84859675
5/21/2020,141808,93538,34979,270325,99.8245938
5/22/2020,141648,93706,35019,270373,99.84231905
5/23/2020,141588,93812,35078,270478,99.88109306
5/24/2020,141518,94287,34905,270710,99.96676514
5/25/2020,141318,94287,34722,270327,99.82533235
5/26/2020,141058,94195,34529,269782,99.62407681
5/27/2020,140948,94042,34525,269515,99.52548006
5/28/2020,140948,93736,34554,269238,99.42319055
5/29/2020,141038,93446,34623,269107,99.37481536
5/30/2020,141478,93401,34717,269596,99.55539143
5/31/2020,141428,93203,34559,269190,99.40546529
6/1/2020,141338,92945,34313,268596,99.18611521
6/2/2020,141278,92733,34255,268266,99.06425406
6/3/2020,141188,92507,34264,267959,98.95088626
6/4/2020,141058,92296,34294,267648,98.83604136
6/5/2020,140768,92055,34299,267122,98.64180207
6/6/2020,140528,91770,34299,266597,98.44793205
6/7/2020,140238,91426,34294,265958,98.21196455
6/8/2020,139948,91067,34274,265289,97.96491876
6/9/2020,139788,90888,34259,264935,97.83419498
6/10/2020,139508,90680,34225,264413,97.64143279
6/11/2020,139528,90650,34308,264486,97.66838996
6/12/2020,139748,90650,34594,264992,97.85524372
6/13/2020,139528,90293,34623,264444,97.65288035
6/14/2020,139238,89789,34475,263502,97.30502216
6/15/2020,138878,89300,34456,262634,96.9844904
6/16/2020,138568,88887,34441,261896,96.71196455
6/17/2020,138328,88666,34411,261405,96.53064993
6/18/2020,138098,88475,34387,260960,96.36632201
6/19/2020,137848,88284,34362,260494,96.19423929
6/20/2020,137588,88093,34338,260019,96.01883309
6/21/2020,137358,87844,34304,259506,95.82939439
6/22/2020,137048,87595,34274,258917,95.61189069
6/23/2020,136668,87054,34230,257952,95.25553914
6/24/2020,136278,86632,34074,256984,94.89807976
6/25/2020,135958,86428,34039,256425,94.69165436
6/26/2020,135628,86152,34000,255780,94.4534712
6/27/2020,135198,86152,33952,255302,94.27695716
6/28/2020,135078,85097,33961,254136,93.84638109
6/29/2020,134768,84708,33981,253457,93.59564254
6/30/2020,134578,84522,33879,252979,93.41912851
7/1/2020,134268,84192,33888,252348,93.18611521
7/2/2020,133938,83692,33859,251489,92.86890694
7/3/2020,133538,83208,33709,250455,92.48707533
7/4/2020,133348,82753,33689,249790,92.24150665
7/5/2020,133058,82258,33655,248971,91.93906942
7/6/2020,132728,81693,33607,248028,91.59084195
7/7/2020,132248,81187,33452,246887,91.16949778
7/8/2020,131748,80654,33298,245700,90.73116691
7/9/2020,131418,80360,33168,244946,90.45273264
7/10/2020,131128,79970,33125,244223,90.18574594
7/11/2020,131048,79844,33221,244113,90.14512555
7/12/2020,131008,79663,33496,244167,90.16506647
7/13/2020,130868,79482,33588,243938,90.08050222
7/14/2020,130398,79260,33443,243101,89.77141802
7/15/2020,129938,78802,33404,242144,89.41802068
7/16/2020,129608,78305,33385,241298,89.105613
7/17/2020,129188,77781,33356,240325,88.74630724
7/18/2020,128838,77218,33336,239392,88.40177253
7/19/2020,128398,76889,33192,238479,88.06462334
7/20/2020,128068,76615,33000,237683,87.77067947
7/21/2020,127578,76206,32732,236516,87.33973412
7/22/2020,127058,75743,32484,235285,86.8851551
7/23/2020,126658,75363,32342,234363,86.54468242
7/24/2020,126228,74929,32308,233465,86.21307238
7/25/2020,125758,74389,32275,232422,85.82791728
7/26/2020,125318,73864,32228,231410,85.45420975
7/27/2020,124818,73314,32077,230209,85.01070901
7/28/2020,124298,72832,31860,228990,84.5605613
7/29/2020,123788,72338,31663,227789,84.11706056
7/30/2020,123388,71926,31438,226752,83.73412112
7/31/2020,122998,71726,31293,226017,83.4627031
8/1/2020,122604,71261,31152,225017,83.09342688
8/2/2020,122228,70786,31084,224098,82.75406204
8/3/2020,121928,70325,31051,223304,82.46085672
8/4/2020,121568,69891,30852,222311,82.09416544
8/5/2020,123908,70812,31667,226387,83.5993353
8/6/2020,124288,71209,31663,227160,83.88478582
8/7/2020,124288,71567,31545,227400,83.97341211
8/8/2020,124658,72658,31480,228796,84.48892171
8/9/2020,124628,72992,31489,229109,84.60450517
8/10/2020,124458,72966,31480,228904,84.52880355
8/11/2020,124218,72792,31256,228266,84.29320532
8/12/2020,124198,73233,31038,228469,84.36816839
8/13/2020,124128,73528,30838,228494,84.3774003
8/14/2020,123868,73542,30640,228050,84.21344165
8/15/2020,123598,73421,30488,227507,84.01292467
8/16/2020,123338,73193,30438,226969,83.81425406
8/17/2020,122998,72899,30392,226289,83.56314623
8/18/2020,122688,72658,30360,225706,83.3478582
8/19/2020,122288,72325,30296,224909,83.05354505
8/20/2020,121958,71979,30268,224205,82.79357459
8/21/2020,121588,71593,30227,223408,82.49926145
8/22/2020,121168,71130,30190,222488,82.15952733
8/23/2020,120788,70654,30154,221596,81.83013294
8/24/2020,120388,70180,30117,220685,81.4937223
8/25/2020,119968,69681,30067,219716,81.13589365
8/26/2020,119558,69196,30013,218767,80.78545052
8/27/2020,119118,68739,29963,217820,80.43574594
8/28/2020,118868,68491,29990,217349,80.26181684
8/29/2020,118618,68244,29976,216838,80.07311669
8/30/2020,118648,67893,30054,216595,79.98338257
8/31/2020,118348,67608,30049,216005,79.7655096
9/1/2020,117978,67194,30003,215175,79.45901034
9/2/2020,117748,66807,29972,214527,79.21971935
9/3/2020,117648,66511,30186,214345,79.15251108
9/4/2020,117478,66190,30168,213836,78.96454948
9/5/2020,117248,65780,30085,213113,78.69756278
9/6/2020,117068,65345,30072,212485,78.46565731
9/7/2020,116848,64912,30058,211818,78.21935007
9/8/2020,116568,64454,30017,211039,77.9316839
9/9/2020,116278,63973,29899,210150,77.60339734
9/10/2020,115988,63505,29731,209224,77.26144756
9/11/2020,115788,63064,29641,208493,76.99150665
9/12/2020,115508,62625,29623,207756,76.71935007
9/13/2020,115238,62137,29595,206970,76.42909897
9/14/2020,115008,61651,29559,206218,76.15140325
9/15/2020,114728,61154,29532,205414,75.85450517
9/16/2020,114428,60622,29348,204398,75.47932053
9/17/2020,114088,60153,29298,203539,75.16211226
9/18/2020,113708,59661,29133,202502,74.77917282
9/19/2020,113348,59145,29079,201572,74.43574594
9/20/2020,112968,58595,29039,200602,74.07754801
9/21/2020,112598,58084,28999,199681,73.73744461
9/22/2020,112198,57574,28954,198726,73.38478582
9/23/2020,111808,57030,28905,197743,73.0217873
9/24/2020,111438,56548,28865,196851,72.69239291
9/25/2020,111098,56020,28692,195810,72.30797637
9/26/2020,110718,55410,28505,194633,71.87333826
9/27/2020,110368,54755,28470,193593,71.48929099
9/28/2020,110048,54211,28430,192689,71.15546529
9/29/2020,109718,53704,28408,191830,70.83825702
9/30/2020,110028,53363,28625,192016,70.90694239
10/1/2020,110268,53457,28811,192536,71.09896603
10/2/2020,110168,53352,28847,192367,71.03655835
10/3/2020,110028,53152,28869,192049,70.91912851
10/4/2020,109768,52919,28847,191534,70.72895126
10/5/2020,109458,52673,28847,190978,70.52363368
10/6/2020,108978,52452,28820,190250,70.25480059
10/7/2020,108528,52243,28785,189556,69.9985229
10/8/2020,108158,51941,28785,188884,69.75036928
10/9/2020,107908,51340,28714,187962,69.4098966
10/10/2020,107638,50650,28479,186767,68.96861152
10/11/2020,107328,50147,28408,185883,68.64217134
10/12/2020,107058,49759,28386,185203,68.39106352
10/13/2020,106758,49022,28325,184105,67.98559823
10/14/2020,106408,48334,28228,182970,67.56646972
10/15/2020,106108,47607,28004,181719,67.10450517
10/16/2020,105798,47095,27825,180718,66.73485968
10/17/2020,105558,46410,27685,179653,66.3415805
10/18/2020,105268,45630,27672,178570,65.94165436
10/19/2020,104938,44847,27655,177440,65.52437223
10/20/2020,104608,44112,27642,176362,65.12629247
10/21/2020,104298,43383,27629,175310,64.73781388
10/22/2020,104028,42660,27477,174165,64.31499261
10/23/2020,103748,41879,27468,173095,63.91986706
10/24/2020,103418,41324,27451,172193,63.58677991
10/25/2020,103108,40792,27434,171334,63.26957164
10/26/2020,102788,40244,27425,170457,62.9457164
10/27/2020,102468,39668,27416,169552,62.61152142
10/28/2020,102158,39158,27403,168719,62.30391433
10/29/2020,101898,38955,27416,168269,62.13774003
10/30/2020,102198,39270,27603,169071,62.43389956
10/31/2020,102458,39956,27755,170169,62.83936484
11/1/2020,102518,40430,27842,170790,63.06868538
11/2/2020,102648,40834,27938,171420,63.30132939
11/3/2020,102768,41250,28030,172048,63.53323486
11/4/2020,102828,41627,28061,172516,63.70605613
11/5/2020,102878,41953,28118,172949,63.86595273
11/6/2020,102888,42226,28171,173285,63.99002954
11/7/2020,102888,42490,28215,173593,64.10376662
11/8/2020,102848,42724,28272,173844,64.19645495
11/9/2020,102738,42936,28307,173981,64.24704579
11/10/2020,102628,43117,28351,174096,64.28951256
11/11/2020,102518,43298,28382,174198,64.32717873
11/12/2020,102658,43640,28422,174720,64.51994092
11/13/2020,102628,43951,28501,175080,64.65288035
11/14/2020,102568,44188,28563,175319,64.74113737
11/15/2020,102508,44414,28612,175534,64.82053176
11/16/2020,102518,44652,28798,175968,64.98079764
11/17/2020,102628,44944,28972,176544,65.19350074
11/18/2020,102518,45227,29092,176837,65.30169867
11/19/2020,102508,45456,29052,177016,65.36779911
11/20/2020,102468,45652,28994,177114,65.40398818
11/21/2020,102568,45871,29070,177509,65.54985229
11/22/2020,102688,46069,29142,177899,65.69387001
11/23/2020,102858,46311,29245,178414,65.88404727
11/24/2020,103208,46752,29361,179321,66.2189808
11/25/2020,103328,47129,29379,179836,66.40915805
11/26/2020,103628,47473,29402,180503,66.65546529
11/27/2020,104078,47897,29709,181684,67.0915805
11/28/2020,104278,48323,29890,182491,67.38958641
11/29/2020,104538,48717,30031,183286,67.683161
11/30/2020,104688,49078,30149,183915,67.91543575
12/1/2020,105918,49770,31522,187210,69.13220089
12/2/2020,107128,50535,32077,189740,70.06646972
12/3/2020,108078,51121,32214,191413,70.68426883
12/4/2020,108888,51687,32446,193021,71.27806499
12/5/2020,109398,52197,32503,194098,71.67577548
12/6/2020,109768,52673,32675,195116,72.05169867
12/7/2020,110008,53094,32708,195810,72.30797637
12/8/2020,110188,53457,32675,196320,72.49630724
12/9/2020,110158,53786,32632,196576,72.59084195
12/10/2020,110288,54140,32570,196998,72.74667651
12/11/2020,110218,54435,32541,197194,72.81905465
12/12/2020,110158,54696,32408,197262,72.84416544
12/13/2020,110088,54957,32323,197368,72.88330871
12/14/2020,110028,55219,32237,197484,72.92614476
12/15/2020,110208,55469,32138,197815,73.04837518
12/16/2020,110318,55673,31940,197931,73.09121123
12/17/2020,110448,55996,31855,198299,73.22710487
12/18/2020,110348,56056,31761,198165,73.17762186
12/19/2020,110288,56248,31513,198049,73.13478582
12/20/2020,110208,56416,31298,197922,73.08788774
12/21/2020,110168,56644,31098,197910,73.08345643
12/22/2020,110108,56873,30922,197903,73.08087149
12/23/2020,109958,57103,30760,197821,73.05059084
12/24/2020,110028,57296,30668,197992,73.11373708
12/25/2020,115078,60919,33158,209155,77.2359675
12/26/2020,122928,70470,35337,228735,84.46639586
12/27/2020,125328,74362,35327,235017,86.78618907
12/28/2020,127218,76479,35217,238914,88.22525849
12/29/2020,128278,77946,35178,241402,89.14401773
12/30/2020,128728,79052,35227,243007,89.73670606
12/31/2020,129148,79886,35257,244291,90.21085672
1/1/2021,129498,80710,35252,245460,90.64254062
1/2/2021,129638,81468,35267,246373,90.97968981
1/3/2021,130028,82498,35297,247823,91.51514032
1/4/2021,130248,83165,35292,248705,91.84084195
1/5/2021,130338,83621,35257,249216,92.0295421
1/6/2021,130248,84063,35222,249533,92.14660266
1/7/2021,130148,84307,35192,249647,92.18870015
1/8/2021,130038,84536,35168,249742,92.22378139
1/9/2021,129868,84694,35153,249715,92.21381093
1/10/2021,129638,84766,35128,249532,92.14623338
1/11/2021,129398,84824,35103,249325,92.06979321
1/12/2021,129118,84881,35073,249072,91.97636632
1/13/2021,128838,84924,34949,248711,91.84305761
1/14/2021,128608,84982,34816,248406,91.73042836
1/15/2021,128258,84982,34672,247912,91.54800591
1/16/2021,127928,84982,34525,247435,91.37186115
1/17/2021,127668,85039,34353,247060,91.23338257
1/18/2021,127368,85039,34176,246583,91.05723781
1/19/2021,127038,85025,33996,246059,90.86373708
1/20/2021,126628,84967,33801,245396,90.61890694
1/21/2021,126348,84895,33612,244855,90.41912851
1/22/2021,125938,84780,33452,244170,90.1661743
1/23/2021,125538,84565,33274,243377,89.87333826
1/24/2021,125108,84221,33077,242406,89.51477105
1/25/2021,124698,83849,32875,241422,89.15140325
1/26/2021,124248,83478,32665,240391,88.77067947
1/27/2021,123738,83165,32503,239406,88.40694239
1/28/2021,123288,82824,32290,238402,88.03618907
1/29/2021,122868,82456,32091,237415,87.67171344
1/30/2021,122348,82046,31883,236277,87.2514771
1/31/2021,121908,81651,31686,235245,86.87038405
2/1/2021,121438,81271,31485,234194,86.48227474
2/2/2021,121128,81004,31321,233453,86.20864106
2/3/2021,120758,80668,31200,232626,85.90324963
2/4/2021,120468,80319,31070,231857,85.61927622
2/5/2021,120128,80011,30949,231088,85.33530281
2/6/2021,119848,79816,30917,230581,85.14807976
2/7/2021,119658,79677,30889,230224,85.01624815
2/8/2021,119458,79552,30866,229876,84.88774003
2/9/2021,119068,79399,30741,229208,84.64106352
2/10/2021,118688,79288,30617,228593,84.41395864
2/11/2021,118368,79163,30465,227996,84.19350074
2/12/2021,117978,78996,30314,227288,83.93205318
2/13/2021,117668,78719,30090,226477,83.63257016
2/14/2021,117448,78498,29972,225918,83.42614476
2/15/2021,117248,78236,29958,225442,83.25036928
2/16/2021,117128,78029,29876,225033,83.0993353
2/17/2021,117098,77946,29958,225002,83.08788774
2/18/2021,117078,77905,29999,224982,83.08050222
2/19/2021,117098,77822,30063,224983,83.08087149
2/20/2021,117018,77712,30072,224802,83.0140325
2/21/2021,116978,77588,29967,224533,82.91469719
2/22/2021,116868,77437,29840,224145,82.77141802
2/23/2021,116798,77314,29641,223753,82.62666174
2/24/2021,116648,77231,29510,223389,82.4922452
2/25/2021,116518,77108,29411,223037,82.36225997
2/26/2021,116548,77081,29307,222936,82.32496307
2/27/2021,116598,76998,29218,222814,82.27991137
2/28/2021,116818,76916,29245,222979,82.34084195
3/1/2021,116998,76916,29289,223203,82.42355982
3/2/2021,117398,77094,29370,223862,82.66691285
3/3/2021,117678,77204,29289,224171,82.7810192
3/4/2021,118028,77341,29316,224685,82.97082718
3/5/2021,118338,77437,29330,225105,83.12592319
3/6/2021,118598,77478,29357,225433,83.24704579
3/7/2021,118858,77492,29370,225720,83.35302806
3/8/2021,119138,77492,29218,225848,83.40029542
3/9/2021,119408,77465,28976,225849,83.4006647
3/10/2021,119578,77492,28731,225801,83.38293944
3/11/2021,120018,77657,28559,226234,83.54283604
3/12/2021,121148,78747,28550,228445,84.35930576
3/13/2021,122948,80752,28878,232578,85.88552437
3/14/2021,124168,82187,29092,235447,86.94497784
3/15/2021,124938,83307,29249,237494,87.70088626
3/16/2021,125418,84035,29236,238689,88.14217134
3/17/2021,125608,84579,29168,239355,88.38810931
3/18/2021,125888,85039,29070,239997,88.62518464
3/19/2021,126868,86283,29361,242512,89.55391433
3/20/2021,127438,87200,29568,244206,90.17946824
3/21/2021,127998,87858,29731,245587,90.6894387
3/22/2021,128538,88460,29926,246924,91.183161
3/23/2021,129168,89035,30190,248393,91.72562777
3/24/2021,129708,89626,30507,249841,92.26033973
3/25/2021,130728,90546,31513,252787,93.34822747
3/26/2021,132478,91591,32780,256849,94.84822747
3/27/2021,134308,92718,34000,261026,96.39069424
3/28/2021,135598,93568,34544,263710,97.38183161
3/29/2021,137018,94394,35382,266794,98.52067947
3/30/2021,137918,94733,35402,268053,98.98559823
3/31/2021,138548,94471,35322,268341,99.09194978
4/1/2021,139418,94440,35407,269265,99.433161
4/2/2021,140128,94563,35322,270013,99.70937962
4/3/2021,140568,94502,35133,270203,99.7795421
4/4/2021,140788,94333,34994,270115,99.74704579
4/5/2021,140838,94088,34825,269751,99.61262925
4/6/2021,140838,93629,34890,269357,99.46713442
4/7/2021,140788,93249,34825,268862,99.28434269
4/8/2021,140708,92870,34860,268438,99.12776957
4/9/2021,140548,92658,34786,267992,98.96307238
4/10/2021,140548,92597,34702,267847,98.90952733
4/11/2021,140568,92552,34732,267852,98.91137371
4/12/2021,140658,92567,34816,268041,98.98116691
4/13/2021,140768,92628,34949,268345,99.09342688
4/14/2021,140728,92658,34959,268345,99.09342688
4/15/2021,140748,92658,35029,268435,99.12666174
4/16/2021,141038,92703,35058,268799,99.26107829
4/17/2021,141168,92900,35058,269126,99.38183161
4/18/2021,141188,93051,35033,269272,99.43574594
4/19/2021,141228,93143,35014,269385,99.47747415
4/20/2021,141258,93249,35103,269610,99.5605613
4/21/2021,141128,93294,35083,269505,99.5217873
4/22/2021,141098,93355,35108,269561,99.54246677
4/23/2021,141058,93385,35128,269571,99.54615953
4/24/2021,141028,93385,35163,269576,99.54800591
4/25/2021,141028,93370,35133,269531,99.53138848
4/26/2021,141028,93310,35098,269436,99.49630724
4/27/2021,140988,93234,35048,269270,99.43500739
4/28/2021,140898,93310,35078,269286,99.44091581
4/29/2021,140988,93401,35024,269413,99.48781388
4/30/2021,142228,94933,35098,272259,100.538774
5/1/2021,143118,96189,35153,274460,101.351551
5/2/2021,143478,96501,35187,275166,101.61226
5/3/2021,143538,96501,35212,275251,101.6436484
5/4/2021,143578,96533,35257,275368,101.6868538
5/5/2021,143688,96501,35457,275646,101.7895126
5/6/2021,143848,96501,35407,275756,101.8301329
5/7/2021,143758,96158,35327,275243,101.6406942
5/8/2021,143608,95956,35292,274856,101.4977843
5/9/2021,143518,96018,35292,274828,101.4874446
5/10/2021,143558,96345,35352,275255,101.6451256
5/11/2021,143498,96548,35347,275393,101.6960857
5/12/2021,143168,96221,35297,274686,101.4350074
5/13/2021,143018,95754,35267,274039,101.1960857
5/14/2021,143008,95304,35242,273554,101.0169867
5/15/2021,142948,95072,35173,273193,100.883678
5/16/2021,142898,94964,35143,273005,100.8142541
5/17/2021,142818,94933,35202,272953,100.7950517
5/18/2021,142678,94764,35133,272575,100.6554653
5/19/2021,142558,94548,35098,272204,100.5184638
5/20/2021,142508,94287,35009,271804,100.3707533
5/21/2021,142338,94026,34964,271328,100.1949778
5/22/2021,142118,93736,34994,270848,100.0177253
5/23/2021,141918,93385,35019,270322,99.82348597
5/24/2021,141668,93051,35029,269748,99.61152142
5/25/2021,141448,92794,34934,269176,99.40029542
5/26/2021,141148,92507,34919,268574,99.17799114
5/27/2021,141118,92296,34850,268264,99.06351551
5/28/2021,141058,92055,34850,267963,98.95236337
5/29/2021,141538,92281,34974,268793,99.25886263
5/30/2021,142088,92613,35103,269804,99.63220089
5/31/2021,142528,92809,35173,270510,99.8929099
6/1/2021,142708,93036,35123,270867,100.0247415
6/2/2021,142618,93127,35043,270788,99.99556869
6/3/2021,142598,93203,34974,270775,99.99076809
6/4/2021,142578,93401,35009,270988,100.0694239
6/5/2021,142528,93767,35033,271328,100.1949778
6/6/2021,142468,93904,35038,271410,100.2252585
6/7/2021,142118,93965,34954,271037,100.0875185
6/8/2021,141788,93827,34806,270421,99.86004431
6/9/2021,141758,93751,34638,270147,99.75886263
6/10/2021,141828,93782,34520,270130,99.75258493
6/11/2021,141778,93599,34411,269788,99.62629247
6/12/2021,141588,93340,34387,269315,99.45162482
6/13/2021,141318,93067,34362,268747,99.24187592
6/14/2021,141028,92824,34338,268190,99.03618907
6/15/2021,140748,92597,34264,267609,98.82163959
6/16/2021,140528,92356,34142,267026,98.60635155
6/17/2021,140608,92191,34108,266907,98.56240768
6/18/2021,140588,91905,34069,266562,98.43500739
6/19/2021,140328,91546,33957,265831,98.16506647
6/20/2021,140058,91217,33927,265202,97.93279173
6/21/2021,139788,90859,33806,264453,97.65620384
6/22/2021,139568,90442,33655,263665,97.36521418
6/23/2021,139288,90055,33559,262902,97.08345643
6/24/2021,138988,89611,33501,262100,96.7872969
6/25/2021,138658,89153,33462,261273,96.48190547
6/26/2021,138368,88637,33414,260419,96.16654357
6/27/2021,138028,88166,33370,259564,95.85081241
6/28/2021,137698,87551,33332,258581,95.48781388
6/29/2021,137288,86996,33163,257447,95.06905465
6/30/2021,136888,86487,32985,256360,94.6676514
7/1/2021,136838,86109,32827,255774,94.45125554
7/2/2021,136818,85790,32804,255412,94.31757755
7/3/2021,136598,85573,32918,255089,94.19830133
7/4/2021,136488,85487,32990,254965,94.15251108
7/5/2021,136208,85212,32990,254410,93.94756278
7/6/2021,135878,84824,32961,253663,93.67171344
7/7/2021,135778,84622,32823,253223,93.50923191
7/8/2021,136168,84493,32761,253422,93.58271787
7/9/2021,136818,84407,33927,255152,94.22156573
7/10/2021,137408,84551,35307,257266,95.00221566
7/11/2021,137808,84594,35352,257754,95.18242245
7/12/2021,138618,85472,35482,259572,95.85376662
7/13/2021,140168,89241,35477,264886,97.81610044
7/14/2021,141478,91306,35377,268161,99.02548006
7/15/2021,142198,92552,35322,270072,99.73116691
7/16/2021,142578,93097,35272,270947,100.0542836
7/17/2021,142818,93112,35242,271172,100.1373708
7/18/2021,143598,93143,35762,272503,100.6288774
7/19/2021,143648,93751,35502,272901,100.7758493
7/20/2021,143358,93797,35367,272522,100.6358936
7/21/2021,143258,94210,35317,272785,100.7330133
7/22/2021,143138,94933,35282,273353,100.9427622
7/23/2021,142858,94949,35252,273059,100.834195
7/24/2021,142528,94610,35232,272370,100.5797637
7/25/2021,142328,94149,35024,271501,100.2588626
7/26/2021,142228,93812,34821,270861,100.0225258
7/27/2021,142008,93462,34835,270305,99.81720827
7/28/2021,141668,93264,34870,269802,99.63146233
7/29/2021,141678,93325,34870,269873,99.65768095
7/30/2021,141568,93340,34791,269699,99.59342688
7/31/2021,141318,93006,34801,269125,99.38146233
8/1/2021,141058,92597,34791,268446,99.13072378
8/2/2021,140878,92356,34776,268010,98.96971935
8/3/2021,140638,92101,34638,267377,98.7359675
8/4/2021,140568,91995,34466,267029,98.60745938
8/5/2021,140348,91621,34446,266415,98.38072378
8/6/2021,139998,91172,34416,265586,98.0745938
8/7/2021,139568,90680,34377,264625,97.71971935
8/8/2021,139108,90174,34343,263625,97.35044313
8/9/2021,138618,89655,34304,262577,96.96344165
8/10/2021,138078,89123,34264,261465,96.5528065
8/11/2021,137588,88548,34220,260356,96.14327917
8/12/2021,137108,88020,34181,259309,95.75664697
8/13/2021,136748,87639,34010,258397,95.41986706
8/14/2021,136618,87565,33840,258023,95.28175775
8/15/2021,136138,87171,33675,256984,94.89807976
8/16/2021,135608,86676,33602,255886,94.49261448
8/17/2021,135398,86196,33539,255133,94.21454948
8/18/2021,135008,85703,33394,254105,93.83493353
8/19/2021,134578,85342,33443,253363,93.56093058
8/20/2021,134218,84996,33559,252773,93.34305761
8/21/2021,134358,84780,33452,252590,93.27548006
8/22/2021,134328,85068,33496,252892,93.38700148
8/23/2021,134878,85544,33772,254194,93.86779911
8/24/2021,136098,86894,34367,257359,95.03655835
8/25/2021,136478,87565,34299,258342,95.39955687
8/26/2021,136328,87917,34215,258460,95.44313146
8/27/2021,136188,88122,34049,258359,95.40583456
8/28/2021,136028,88357,33840,258225,95.35635155
8/29/2021,135848,88445,33578,257871,95.22562777
8/30/2021,135648,88460,33288,257396,95.05022157
8/31/2021,135438,88210,33269,256917,94.87333826
9/1/2021,135188,88137,33173,256498,94.71861152
9/2/2021,135958,88357,33918,258233,95.35930576
9/3/2021,136308,88710,34416,259434,95.8028065
9/4/2021,136658,88799,34549,260006,96.0140325
9/5/2021,136868,88813,34633,260314,96.12776957
9/6/2021,137028,88828,34697,260553,96.21602659
9/7/2021,137178,88872,34529,260579,96.22562777
9/8/2021,136798,88858,34098,259754,95.92097489
9/9/2021,137228,88858,34020,260106,96.05096012
9/10/2021,137588,88902,33952,260442,96.17503693
9/11/2021,137628,88755,33704,260087,96.04394387
9/12/2021,137568,88416,33423,259407,95.79283604
9/13/2021,137428,88078,33134,258640,95.50960118
9/14/2021,137158,87756,33153,258067,95.29800591
9/15/2021,136398,87259,33153,256810,94.8338257
9/16/2021,136048,87011,33433,256492,94.71639586
9/17/2021,135558,86807,33505,255870,94.48670606
9/18/2021,134928,86312,33559,254799,94.09121123
9/19/2021,134268,85776,33617,253661,93.67097489
9/20/2021,133528,85198,33646,252372,93.19497784
9/21/2021,132798,84594,33443,250835,92.6274003
9/22/2021,132048,84063,33192,249303,92.06166913
9/23/2021,131768,83621,32947,248336,91.70457903
9/24/2021,133758,84680,34157,252595,93.27732644
9/25/2021,134918,86065,34544,255527,94.36004431
9/26/2021,135438,86370,34382,256190,94.60487445
9/27/2021,135468,86385,34103,255956,94.51846381
9/28/2021,135348,86225,33777,255350,94.29468242
9/29/2021,134988,85935,33452,254375,93.93463811
9/30/2021,134678,85544,33067,253289,93.53360414
10/1/2021,134258,85039,32665,251962,93.04357459
10/2/2021,133668,84508,32247,250423,92.47525849
10/3/2021,133098,83935,31822,248855,91.89623338
10/4/2021,132528,83364,31452,247344,91.33825702
10/5/2021,133328,83293,31780,248401,91.72858198
10/6/2021,133278,83165,31926,248369,91.71676514
10/7/2021,133028,82767,31992,247787,91.50184638
10/8/2021,132638,82385,32058,247081,91.24113737
10/9/2021,132178,81961,32096,246235,90.92872969
10/10/2021,131628,81581,32110,245319,90.59047267
10/11/2021,131008,81229,32114,244351,90.23301329
10/12/2021,130428,80836,32114,243378,89.87370753
10/13/2021,129778,80430,32110,242318,89.48227474
10/14/2021,129098,79997,32077,241172,89.05908419
10/15/2021,128368,79733,32048,240149,88.68131462
10/16/2021,127688,79454,32029,239171,88.32016248
10/17/2021,127318,79719,32091,239128,88.3042836
10/18/2021,126778,80081,32105,238964,88.2437223
10/19/2021,126228,80207,31850,238285,87.99298375
10/20/2021,125488,80291,31550,237329,87.63995569
10/21/2021,124828,80291,31275,236394,87.29468242
10/22/2021,124248,80263,30996,235507,86.96713442
10/23/2021,123598,80053,30931,234582,86.62555391
10/24/2021,122898,79788,30880,233566,86.25036928
10/25/2021,122518,79538,30866,232922,86.01255539
10/26/2021,122578,79705,31084,233367,86.17688331
10/27/2021,129868,83949,34603,248420,91.73559823
10/28/2021,133558,87171,35332,256061,94.55723781
10/29/2021,135328,88799,35357,259484,95.82127031
10/30/2021,136478,89744,35332,261554,96.58567208
10/31/2021,137198,90263,35327,262788,97.04135894
11/1/2021,137768,90531,35287,263586,97.33604136
11/2/2021,138078,90576,35267,263921,97.45974889
11/3/2021,137938,90561,35247,263746,97.39512555
11/4/2021,137558,90352,35252,263162,97.17946824
11/5/2021,137088,90055,35242,262385,96.89254062
11/6/2021,136568,89700,35222,261490,96.5620384
11/7/2021,135958,89286,35212,260456,96.18020679
11/8/2021,135308,88813,35207,259328,95.76366322
11/9/2021,134648,88284,35192,258124,95.31905465
11/10/2021,133918,87727,35173,256818,94.83677991
11/11/2021,133398,87186,35009,255593,94.38441654
11/12/2021,132868,86690,34855,254413,93.94867061
11/13/2021,133398,87595,35237,256230,94.61964549
11/14/2021,134098,88475,35302,257875,95.22710487
11/15/2021,134398,89108,35262,258768,95.55686854
11/16/2021,134598,89404,35158,259160,95.70162482
11/17/2021,134428,89492,35038,258958,95.62703102
11/18/2021,134258,89404,34944,258606,95.49704579
11/19/2021,134128,89389,34885,258402,95.42171344
11/20/2021,133918,89300,34781,257999,95.27289513
11/21/2021,133558,89123,34682,257363,95.03803545
11/22/2021,133308,88946,34579,256833,94.84231905
11/23/2021,133058,88710,34485,256253,94.62813885
11/24/2021,132618,88445,34230,255293,94.27363368
11/25/2021,132228,88005,34020,254253,93.88958641
11/26/2021,131878,87639,33888,253405,93.57644018
11/27/2021,131518,87303,33757,252578,93.27104874
11/28/2021,131058,86981,33617,251656,92.93057607
11/29/2021,130588,86559,33612,250759,92.5993353
11/30/2021,130078,86123,33496,249697,92.20716396
